"filename", "language", "YAML", "Java", "comment", "blank", "total"
"d:\panling\yuehua-plugin\src\main\java\com\xiaoxiaoowo\yuehua\Yuehua.java", "Java", 0, 18, 9, 9, 36
"d:\panling\yuehua-plugin\src\main\java\com\xiaoxiaoowo\yuehua\attribute\AttributeSet.java", "Java", 0, 10, 0, 1, 11
"d:\panling\yuehua-plugin\src\main\java\com\xiaoxiaoowo\yuehua\attribute\attributes\jingong\ZhenfaAdd.java", "Java", 0, -2, 0, 0, -2
"d:\panling\yuehua-plugin\src\main\java\com\xiaoxiaoowo\yuehua\attribute\attributes\vanilla\Jump.java", "Java", 0, 2, 0, 1, 3
"d:\panling\yuehua-plugin\src\main\java\com\xiaoxiaoowo\yuehua\attribute\attributes\vanilla\Speed.java", "Java", 0, 2, 0, 1, 3
"d:\panling\yuehua-plugin\src\main\java\com\xiaoxiaoowo\yuehua\commands\Test.java", "Java", 0, 47, 0, 13, 60
"d:\panling\yuehua-plugin\src\main\java\com\xiaoxiaoowo\yuehua\commands\blockcommand\Advancement.java", "Java", 0, 11, 0, 3, 14
"d:\panling\yuehua-plugin\src\main\java\com\xiaoxiaoowo\yuehua\commands\blockcommand\IntoGame.java", "Java", 0, 93, 1, 9, 103
"d:\panling\yuehua-plugin\src\main\java\com\xiaoxiaoowo\yuehua\commands\blockcommand\MyBossSpawn.java", "Java", 0, 25, 0, 2, 27
"d:\panling\yuehua-plugin\src\main\java\com\xiaoxiaoowo\yuehua\commands\blockcommand\MySpawn.java", "Java", 0, 34, 0, 4, 38
"d:\panling\yuehua-plugin\src\main\java\com\xiaoxiaoowo\yuehua\commands\blockcommand\RenOu2.java", "Java", 0, -3, 0, 0, -3
"d:\panling\yuehua-plugin\src\main\java\com\xiaoxiaoowo\yuehua\commands\blockcommand\RenOu3.java", "Java", 0, 64, 0, 8, 72
"d:\panling\yuehua-plugin\src\main\java\com\xiaoxiaoowo\yuehua\commands\blockcommand\Select.java", "Java", 0, -1, 0, 0, -1
"d:\panling\yuehua-plugin\src\main\java\com\xiaoxiaoowo\yuehua\commands\blockcommand\StoreRelifeStone.java", "Java", 0, 1, 0, 1, 2
"d:\panling\yuehua-plugin\src\main\java\com\xiaoxiaoowo\yuehua\commands\opcommand\A.java", "Java", 0, 21, 0, 4, 25
"d:\panling\yuehua-plugin\src\main\java\com\xiaoxiaoowo\yuehua\commands\opcommand\Check.java", "Java", 0, 3, 0, 2, 5
"d:\panling\yuehua-plugin\src\main\java\com\xiaoxiaoowo\yuehua\commands\opcommand\FixLore.java", "Java", 0, 23, 0, 4, 27
"d:\panling\yuehua-plugin\src\main\java\com\xiaoxiaoowo\yuehua\commands\opcommand\GI.java", "Java", 0, 3, 0, 0, 3
"d:\panling\yuehua-plugin\src\main\java\com\xiaoxiaoowo\yuehua\commands\opcommand\MySave.java", "Java", 0, 1, 0, 0, 1
"d:\panling\yuehua-plugin\src\main\java\com\xiaoxiaoowo\yuehua\commands\opcommand\R.java", "Java", 0, 21, 0, 4, 25
"d:\panling\yuehua-plugin\src\main\java\com\xiaoxiaoowo\yuehua\commands\opcommand\Summon.java", "Java", 0, 33, 0, -1, 32
"d:\panling\yuehua-plugin\src\main\java\com\xiaoxiaoowo\yuehua\commands\opcommand\data\DataGet.java", "Java", 0, 4, 0, 0, 4
"d:\panling\yuehua-plugin\src\main\java\com\xiaoxiaoowo\yuehua\commands\playercommand\ArrowCMD.java", "Java", 0, 2, 0, 0, 2
"d:\panling\yuehua-plugin\src\main\java\com\xiaoxiaoowo\yuehua\commands\playercommand\Check.java", "Java", 0, 102, 0, 20, 122
"d:\panling\yuehua-plugin\src\main\java\com\xiaoxiaoowo\yuehua\commands\playercommand\Sell.java", "Java", 0, 2, 0, 0, 2
"d:\panling\yuehua-plugin\src\main\java\com\xiaoxiaoowo\yuehua\commands\playercommand\Yhteam.java", "Java", 0, 6, 0, 1, 7
"d:\panling\yuehua-plugin\src\main\java\com\xiaoxiaoowo\yuehua\commands\playercommand\completer\Check.java", "Java", 0, 16, 0, 4, 20
"d:\panling\yuehua-plugin\src\main\java\com\xiaoxiaoowo\yuehua\data\DanData.java", "Java", 0, -11, 0, 4, -7
"d:\panling\yuehua-plugin\src\main\java\com\xiaoxiaoowo\yuehua\data\Data.java", "Java", 0, 409, 38, 74, 521
"d:\panling\yuehua-plugin\src\main\java\com\xiaoxiaoowo\yuehua\data\GongData.java", "Java", 0, -7, 4, -7, -10
"d:\panling\yuehua-plugin\src\main\java\com\xiaoxiaoowo\yuehua\data\MonsterData.java", "Java", 0, 26, 0, 12, 38
"d:\panling\yuehua-plugin\src\main\java\com\xiaoxiaoowo\yuehua\data\PetData.java", "Java", 0, -4, 0, 0, -4
"d:\panling\yuehua-plugin\src\main\java\com\xiaoxiaoowo\yuehua\data\ZhanData.java", "Java", 0, -11, 0, -3, -14
"d:\panling\yuehua-plugin\src\main\java\com\xiaoxiaoowo\yuehua\data\slot\SlotBuilder.java", "Java", 0, 18, 0, 4, 22
"d:\panling\yuehua-plugin\src\main\java\com\xiaoxiaoowo\yuehua\data\slot\special\BeiDouMieShen.java", "Java", 0, 15, 0, 4, 19
"d:\panling\yuehua-plugin\src\main\java\com\xiaoxiaoowo\yuehua\display\utils\DisPlayUtils.java", "Java", 0, 48, 5, 28, 81
"d:\panling\yuehua-plugin\src\main\java\com\xiaoxiaoowo\yuehua\entity\monster\Renou.java", "Java", 0, -54, -17, -17, -88
"d:\panling\yuehua-plugin\src\main\java\com\xiaoxiaoowo\yuehua\entity\monster\Renou2.java", "Java", 0, -57, -17, -17, -91
"d:\panling\yuehua-plugin\src\main\java\com\xiaoxiaoowo\yuehua\entity\monster\east\boss\JIANXIGUIMEI.java", "Java", 0, 44, 25, 22, 91
"d:\panling\yuehua-plugin\src\main\java\com\xiaoxiaoowo\yuehua\entity\monster\east\boss\LinYouDuZhu.java", "Java", 0, 29, 21, 17, 67
"d:\panling\yuehua-plugin\src\main\java\com\xiaoxiaoowo\yuehua\entity\monster\east\boss\ZHIZHUNVWANG.java", "Java", 0, 29, 9, 11, 49
"d:\panling\yuehua-plugin\src\main\java\com\xiaoxiaoowo\yuehua\entity\monster\east\normal\ChiJianJiangShi.java", "Java", 0, 51, 25, 21, 97
"d:\panling\yuehua-plugin\src\main\java\com\xiaoxiaoowo\yuehua\entity\monster\east\normal\DuFeng.java", "Java", 0, 28, 21, 17, 66
"d:\panling\yuehua-plugin\src\main\java\com\xiaoxiaoowo\yuehua\entity\monster\east\normal\EastNormalZombie.java", "Java", 0, -50, -16, -16, -82
"d:\panling\yuehua-plugin\src\main\java\com\xiaoxiaoowo\yuehua\entity\monster\east\normal\JiangShi.java", "Java", 0, 43, 25, 20, 88
"d:\panling\yuehua-plugin\src\main\java\com\xiaoxiaoowo\yuehua\entity\monster\east\normal\KuGuGongJianShou.java", "Java", 0, 50, 25, 21, 96
"d:\panling\yuehua-plugin\src\main\java\com\xiaoxiaoowo\yuehua\entity\monster\east\normal\KuLou.java", "Java", 0, 42, 25, 21, 88
"d:\panling\yuehua-plugin\src\main\java\com\xiaoxiaoowo\yuehua\entity\monster\east\normal\ZhiZhu.java", "Java", 0, 28, 21, 20, 69
"d:\panling\yuehua-plugin\src\main\java\com\xiaoxiaoowo\yuehua\entity\monster\east\normal\ZhiZhuJinYin.java", "Java", 0, 28, 21, 18, 67
"d:\panling\yuehua-plugin\src\main\java\com\xiaoxiaoowo\yuehua\entity\monster\east\special\ShanshenShooter.java", "Java", 0, 50, 25, 20, 95
"d:\panling\yuehua-plugin\src\main\java\com\xiaoxiaoowo\yuehua\entity\monster\east\special\ShanshenSpider.java", "Java", 0, 28, 21, 17, 66
"d:\panling\yuehua-plugin\src\main\java\com\xiaoxiaoowo\yuehua\entity\monster\east\special\ShanshenZombie.java", "Java", 0, 51, 25, 21, 97
"d:\panling\yuehua-plugin\src\main\java\com\xiaoxiaoowo\yuehua\entity\monster\east\special\YaoJinShooter.java", "Java", 0, 50, 25, 21, 96
"d:\panling\yuehua-plugin\src\main\java\com\xiaoxiaoowo\yuehua\entity\monster\east\special\YaoJingMiFeng.java", "Java", 0, 28, 21, 18, 67
"d:\panling\yuehua-plugin\src\main\java\com\xiaoxiaoowo\yuehua\entity\monster\east\special\YaoJingPanda.java", "Java", 0, 29, 21, 18, 68
"d:\panling\yuehua-plugin\src\main\java\com\xiaoxiaoowo\yuehua\entity\monster\other\Renou.java", "Java", 0, 54, 17, 17, 88
"d:\panling\yuehua-plugin\src\main\java\com\xiaoxiaoowo\yuehua\entity\monster\other\Renou2.java", "Java", 0, 56, 17, 17, 90
"d:\panling\yuehua-plugin\src\main\java\com\xiaoxiaoowo\yuehua\entity\monster\other\Renou3.java", "Java", 0, 59, 17, 18, 94
"d:\panling\yuehua-plugin\src\main\java\com\xiaoxiaoowo\yuehua\entity\monster\other\TemplateMonster.java", "Java", 0, 53, 25, 21, 99
"d:\panling\yuehua-plugin\src\main\java\com\xiaoxiaoowo\yuehua\entity\monster\other\TemplateShooter.java", "Java", 0, 54, 13, 15, 82
"d:\panling\yuehua-plugin\src\main\java\com\xiaoxiaoowo\yuehua\entity\npc\dz\ArmorChest.java", "Java", 0, 28, 0, 4, 32
"d:\panling\yuehua-plugin\src\main\java\com\xiaoxiaoowo\yuehua\entity\npc\dz\ArmorFeet.java", "Java", 0, 28, 0, 3, 31
"d:\panling\yuehua-plugin\src\main\java\com\xiaoxiaoowo\yuehua\entity\npc\dz\ArmorHead.java", "Java", 0, 27, 0, 5, 32
"d:\panling\yuehua-plugin\src\main\java\com\xiaoxiaoowo\yuehua\entity\npc\dz\ArmorLeg.java", "Java", 0, 28, 0, 4, 32
"d:\panling\yuehua-plugin\src\main\java\com\xiaoxiaoowo\yuehua\entity\npc\dz\DUShipin.java", "Java", 0, -1, 0, 0, -1
"d:\panling\yuehua-plugin\src\main\java\com\xiaoxiaoowo\yuehua\entity\npc\dz\MINGZHUTANG.java", "Java", 0, 74, 0, 11, 85
"d:\panling\yuehua-plugin\src\main\java\com\xiaoxiaoowo\yuehua\entity\npc\dz\TIEJIANGPU.java", "Java", 0, 44, 0, 6, 50
"d:\panling\yuehua-plugin\src\main\java\com\xiaoxiaoowo\yuehua\entity\npc\dz\Ys1.java", "Java", 0, -2, 0, 0, -2
"d:\panling\yuehua-plugin\src\main\java\com\xiaoxiaoowo\yuehua\entity\npc\east\EastIngerBue.java", "Java", 0, 79, 4, 26, 109
"d:\panling\yuehua-plugin\src\main\java\com\xiaoxiaoowo\yuehua\entity\npc\east\EastQianZhuang.java", "Java", 0, 86, 4, 17, 107
"d:\panling\yuehua-plugin\src\main\java\com\xiaoxiaoowo\yuehua\entity\npc\east\LaoLieHu.java", "Java", 0, 49, 4, 11, 64
"d:\panling\yuehua-plugin\src\main\java\com\xiaoxiaoowo\yuehua\entity\npc\east\SHANSHENMIAO.java", "Java", 0, 102, 4, 22, 128
"d:\panling\yuehua-plugin\src\main\java\com\xiaoxiaoowo\yuehua\entity\npc\east\SHENMUYAOJIN.java", "Java", 0, 105, 4, 20, 129
"d:\panling\yuehua-plugin\src\main\java\com\xiaoxiaoowo\yuehua\entity\npc\food\MEISHIJIA.java", "Java", 0, 38, 4, 15, 57
"d:\panling\yuehua-plugin\src\main\java\com\xiaoxiaoowo\yuehua\entity\npc\food\SUSHIFAN.java", "Java", 0, -9, 0, 0, -9
"d:\panling\yuehua-plugin\src\main\java\com\xiaoxiaoowo\yuehua\entity\npc\middle\BUMINSHI.java", "Java", 0, 74, 0, 14, 88
"d:\panling\yuehua-plugin\src\main\java\com\xiaoxiaoowo\yuehua\entity\npc\middle\CAOYAOSHOUCANGJIA.java", "Java", 0, 61, 4, 13, 78
"d:\panling\yuehua-plugin\src\main\java\com\xiaoxiaoowo\yuehua\entity\npc\middle\IngredientBuy.java", "Java", 0, 118, 4, 36, 158
"d:\panling\yuehua-plugin\src\main\java\com\xiaoxiaoowo\yuehua\entity\npc\middle\LIANDANFANGXIAOER.java", "Java", 0, 72, 4, 18, 94
"d:\panling\yuehua-plugin\src\main\java\com\xiaoxiaoowo\yuehua\entity\npc\middle\LIANDANZHANGGUI.java", "Java", 0, 41, 4, 12, 57
"d:\panling\yuehua-plugin\src\main\java\com\xiaoxiaoowo\yuehua\entity\npc\middle\MoneLootBuy2.java", "Java", 0, 79, 4, 24, 107
"d:\panling\yuehua-plugin\src\main\java\com\xiaoxiaoowo\yuehua\entity\npc\middle\MoneyLootBuy.java", "Java", 0, 102, 4, 28, 134
"d:\panling\yuehua-plugin\src\main\java\com\xiaoxiaoowo\yuehua\entity\npc\middle\MoneyLootBuy3.java", "Java", 0, 48, 4, 21, 73
"d:\panling\yuehua-plugin\src\main\java\com\xiaoxiaoowo\yuehua\entity\npc\middle\YuanSuHuiShou.java", "Java", 0, 75, 4, 23, 102
"d:\panling\yuehua-plugin\src\main\java\com\xiaoxiaoowo\yuehua\entity\npc\middle\YuanSuZhiHuanYuan.java", "Java", 0, 113, 4, 25, 142
"d:\panling\yuehua-plugin\src\main\java\com\xiaoxiaoowo\yuehua\entity\npc\middle\ZAHUO.java", "Java", 0, 5, 0, 1, 6
"d:\panling\yuehua-plugin\src\main\java\com\xiaoxiaoowo\yuehua\entity\npc\middle\ZHIBUFANG.java", "Java", 0, 80, 4, 20, 104
"d:\panling\yuehua-plugin\src\main\java\com\xiaoxiaoowo\yuehua\entity\npc\middle\ZHINV.java", "Java", 0, 15, 0, -2, 13
"d:\panling\yuehua-plugin\src\main\java\com\xiaoxiaoowo\yuehua\entity\npc\qiansigu\DAN.java", "Java", 0, 73, 4, 16, 93
"d:\panling\yuehua-plugin\src\main\java\com\xiaoxiaoowo\yuehua\entity\npc\qiansigu\ZHANGGUI.java", "Java", 0, 72, 4, 15, 91
"d:\panling\yuehua-plugin\src\main\java\com\xiaoxiaoowo\yuehua\entity\npc\tea\CHUYIYE.java", "Java", 0, 42, 4, 11, 57
"d:\panling\yuehua-plugin\src\main\java\com\xiaoxiaoowo\yuehua\entity\npc\tea\TINGZHI.java", "Java", 0, 42, 4, 11, 57
"d:\panling\yuehua-plugin\src\main\java\com\xiaoxiaoowo\yuehua\entity\npc\tea\XIAOER.java", "Java", 0, 57, 4, 19, 80
"d:\panling\yuehua-plugin\src\main\java\com\xiaoxiaoowo\yuehua\entity\npc\yushi\Bingshuangshi.java", "Java", 0, -1, 0, 0, -1
"d:\panling\yuehua-plugin\src\main\java\com\xiaoxiaoowo\yuehua\entity\pet\other\FeiXianJian.java", "Java", 0, 24, 5, 7, 36
"d:\panling\yuehua-plugin\src\main\java\com\xiaoxiaoowo\yuehua\event\Inventory\Click.java", "Java", 0, 612, 10, 166, 788
"d:\panling\yuehua-plugin\src\main\java\com\xiaoxiaoowo\yuehua\event\Inventory\Close.java", "Java", 0, -2, 0, 4, 2
"d:\panling\yuehua-plugin\src\main\java\com\xiaoxiaoowo\yuehua\event\Projectile\Hit.java", "Java", 0, 54, 4, 1, 59
"d:\panling\yuehua-plugin\src\main\java\com\xiaoxiaoowo\yuehua\event\block\CauldronLevelChange.java", "Java", 0, 21, 0, 4, 25
"d:\panling\yuehua-plugin\src\main\java\com\xiaoxiaoowo\yuehua\event\block\Ingite.java", "Java", 0, 11, 0, 4, 15
"d:\panling\yuehua-plugin\src\main\java\com\xiaoxiaoowo\yuehua\event\entity\AddToWorld.java", "Java", 0, 113, 0, 25, 138
"d:\panling\yuehua-plugin\src\main\java\com\xiaoxiaoowo\yuehua\event\entity\Combust.java", "Java", 0, 17, 0, 4, 21
"d:\panling\yuehua-plugin\src\main\java\com\xiaoxiaoowo\yuehua\event\entity\Damage.java", "Java", 0, -3, -1, 2, -2
"d:\panling\yuehua-plugin\src\main\java\com\xiaoxiaoowo\yuehua\event\entity\DamageByEntity.java", "Java", 0, 63, 3, 42, 108
"d:\panling\yuehua-plugin\src\main\java\com\xiaoxiaoowo\yuehua\event\entity\Death.java", "Java", 0, 172, 0, 28, 200
"d:\panling\yuehua-plugin\src\main\java\com\xiaoxiaoowo\yuehua\event\entity\LoadCrossBow.java", "Java", 0, 0, 0, 2, 2
"d:\panling\yuehua-plugin\src\main\java\com\xiaoxiaoowo\yuehua\event\entity\PotionSpLash.java", "Java", 0, -2, 0, 2, 0
"d:\panling\yuehua-plugin\src\main\java\com\xiaoxiaoowo\yuehua\event\entity\RegainHealth.java", "Java", 0, -2, 0, -2, -4
"d:\panling\yuehua-plugin\src\main\java\com\xiaoxiaoowo\yuehua\event\entity\RemoveFromWorld.java", "Java", 0, 7, 0, 0, 7
"d:\panling\yuehua-plugin\src\main\java\com\xiaoxiaoowo\yuehua\event\entity\ShootBow.java", "Java", 0, -4, 13, 1, 10
"d:\panling\yuehua-plugin\src\main\java\com\xiaoxiaoowo\yuehua\event\player\ConsumeItem.java", "Java", 0, 45, 0, 3, 48
"d:\panling\yuehua-plugin\src\main\java\com\xiaoxiaoowo\yuehua\event\player\Death.java", "Java", 0, 1, -52, 0, -51
"d:\panling\yuehua-plugin\src\main\java\com\xiaoxiaoowo\yuehua\event\player\Interact.java", "Java", 0, 441, 1, 28, 470
"d:\panling\yuehua-plugin\src\main\java\com\xiaoxiaoowo\yuehua\event\player\InventorySlotChange.java", "Java", 0, 2, 0, 1, 3
"d:\panling\yuehua-plugin\src\main\java\com\xiaoxiaoowo\yuehua\event\player\Join.java", "Java", 0, 84, 7, 19, 110
"d:\panling\yuehua-plugin\src\main\java\com\xiaoxiaoowo\yuehua\event\player\LevelChange.java", "Java", 0, 34, 0, 10, 44
"d:\panling\yuehua-plugin\src\main\java\com\xiaoxiaoowo\yuehua\event\player\Quit.java", "Java", 0, 9, 1, 0, 10
"d:\panling\yuehua-plugin\src\main\java\com\xiaoxiaoowo\yuehua\event\player\Teleport.java", "Java", 0, 6, 0, -1, 5
"d:\panling\yuehua-plugin\src\main\java\com\xiaoxiaoowo\yuehua\guis\Advancenment.java", "Java", 0, 3, 0, 2, 5
"d:\panling\yuehua-plugin\src\main\java\com\xiaoxiaoowo\yuehua\guis\DuanZao.java", "Java", 0, 45, 0, 15, 60
"d:\panling\yuehua-plugin\src\main\java\com\xiaoxiaoowo\yuehua\guis\OpGui.java", "Java", 0, -16, 0, -7, -23
"d:\panling\yuehua-plugin\src\main\java\com\xiaoxiaoowo\yuehua\guis\Recipe.java", "Java", 0, 158, 2, 37, 197
"d:\panling\yuehua-plugin\src\main\java\com\xiaoxiaoowo\yuehua\guis\Task.java", "Java", 0, 148, 1, 21, 170
"d:\panling\yuehua-plugin\src\main\java\com\xiaoxiaoowo\yuehua\guis\Yh.java", "Java", 0, 162, 10, 24, 196
"d:\panling\yuehua-plugin\src\main\java\com\xiaoxiaoowo\yuehua\guis\bank\JianDai.java", "Java", 0, 113, 0, 17, 130
"d:\panling\yuehua-plugin\src\main\java\com\xiaoxiaoowo\yuehua\guis\bank\MoneyBank.java", "Java", 0, 175, 3, 32, 210
"d:\panling\yuehua-plugin\src\main\java\com\xiaoxiaoowo\yuehua\guis\bank\YuanSuBank.java", "Java", 0, 337, 4, 70, 411
"d:\panling\yuehua-plugin\src\main\java\com\xiaoxiaoowo\yuehua\guis\op\OpGui.java", "Java", 0, 16, 0, 7, 23
"d:\panling\yuehua-plugin\src\main\java\com\xiaoxiaoowo\yuehua\guis\op\OpTp.java", "Java", 0, 52, 0, 10, 62
"d:\panling\yuehua-plugin\src\main\java\com\xiaoxiaoowo\yuehua\items\Book.java", "Java", 0, 379, 0, 49, 428
"d:\panling\yuehua-plugin\src\main\java\com\xiaoxiaoowo\yuehua\items\PINZHENG.java", "Java", 0, 738, 10, 70, 818
"d:\panling\yuehua-plugin\src\main\java\com\xiaoxiaoowo\yuehua\items\Skill.java", "Java", 0, 13, 0, 4, 17
"d:\panling\yuehua-plugin\src\main\java\com\xiaoxiaoowo\yuehua\items\dz\Core.java", "Java", 0, 3685, 61, 703, 4449
"d:\panling\yuehua-plugin\src\main\java\com\xiaoxiaoowo\yuehua\items\dz\FuLing.java", "Java", 0, 862, 13, 90, 965
"d:\panling\yuehua-plugin\src\main\java\com\xiaoxiaoowo\yuehua\items\dz\Ingredient.java", "Java", 0, 885, 30, 97, 1012
"d:\panling\yuehua-plugin\src\main\java\com\xiaoxiaoowo\yuehua\items\dz\TehuaShui.java", "Java", 0, 316, 0, 82, 398
"d:\panling\yuehua-plugin\src\main\java\com\xiaoxiaoowo\yuehua\items\dz\YuShi.java", "Java", 0, 1577, 13, 170, 1760
"d:\panling\yuehua-plugin\src\main\java\com\xiaoxiaoowo\yuehua\items\dz\YuanSu.java", "Java", 0, 223, 4, 38, 265
"d:\panling\yuehua-plugin\src\main\java\com\xiaoxiaoowo\yuehua\items\liandan\Dan.java", "Java", 0, 121, 11, 38, 170
"d:\panling\yuehua-plugin\src\main\java\com\xiaoxiaoowo\yuehua\items\liandan\Herb.java", "Java", 0, 196, 4, 24, 224
"d:\panling\yuehua-plugin\src\main\java\com\xiaoxiaoowo\yuehua\items\monsterzhuangbei\Boot.java", "Java", 0, 177, 0, 30, 207
"d:\panling\yuehua-plugin\src\main\java\com\xiaoxiaoowo\yuehua\items\monsterzhuangbei\Bow.java", "Java", 0, 71, 0, 19, 90
"d:\panling\yuehua-plugin\src\main\java\com\xiaoxiaoowo\yuehua\items\monsterzhuangbei\Chest.java", "Java", 0, 177, 0, 31, 208
"d:\panling\yuehua-plugin\src\main\java\com\xiaoxiaoowo\yuehua\items\monsterzhuangbei\Helmet.java", "Java", 0, 109, 0, 27, 136
"d:\panling\yuehua-plugin\src\main\java\com\xiaoxiaoowo\yuehua\items\monsterzhuangbei\Leg.java", "Java", 0, 93, 0, 29, 122
"d:\panling\yuehua-plugin\src\main\java\com\xiaoxiaoowo\yuehua\items\monsterzhuangbei\Weapon.java", "Java", 0, 469, 23, 144, 636
"d:\panling\yuehua-plugin\src\main\java\com\xiaoxiaoowo\yuehua\items\other\Collection.java", "Java", 0, 157, 0, 31, 188
"d:\panling\yuehua-plugin\src\main\java\com\xiaoxiaoowo\yuehua\items\other\Feather.java", "Java", 0, 203, 0, 34, 237
"d:\panling\yuehua-plugin\src\main\java\com\xiaoxiaoowo\yuehua\items\other\Food.java", "Java", 0, 808, 8, 83, 899
"d:\panling\yuehua-plugin\src\main\java\com\xiaoxiaoowo\yuehua\items\other\FuBen.java", "Java", 0, 140, 2, 17, 159
"d:\panling\yuehua-plugin\src\main\java\com\xiaoxiaoowo\yuehua\items\other\Money.java", "Java", 0, 94, 0, 22, 116
"d:\panling\yuehua-plugin\src\main\java\com\xiaoxiaoowo\yuehua\items\other\MoneyLoot.java", "Java", 0, 202, 6, 55, 263
"d:\panling\yuehua-plugin\src\main\java\com\xiaoxiaoowo\yuehua\items\other\Other.java", "Java", 0, 64, 0, 18, 82
"d:\panling\yuehua-plugin\src\main\java\com\xiaoxiaoowo\yuehua\items\other\RaceProvince.java", "Java", 0, 85, 0, 25, 110
"d:\panling\yuehua-plugin\src\main\java\com\xiaoxiaoowo\yuehua\items\other\XP.java", "Java", 0, 105, 1, 21, 127
"d:\panling\yuehua-plugin\src\main\java\com\xiaoxiaoowo\yuehua\items\zhuangbei\ArmorChest.java", "Java", 0, 1011, 4, 31, 1046
"d:\panling\yuehua-plugin\src\main\java\com\xiaoxiaoowo\yuehua\items\zhuangbei\ArmorFeet.java", "Java", 0, 990, 4, 31, 1025
"d:\panling\yuehua-plugin\src\main\java\com\xiaoxiaoowo\yuehua\items\zhuangbei\ArmorHead.java", "Java", 0, 999, 4, 61, 1064
"d:\panling\yuehua-plugin\src\main\java\com\xiaoxiaoowo\yuehua\items\zhuangbei\ArmorLeg.java", "Java", 0, 999, 4, 36, 1039
"d:\panling\yuehua-plugin\src\main\java\com\xiaoxiaoowo\yuehua\items\zhuangbei\BiWeapon.java", "Java", 0, 711, 3, 58, 772
"d:\panling\yuehua-plugin\src\main\java\com\xiaoxiaoowo\yuehua\items\zhuangbei\Fabao.java", "Java", 0, 1361, 12, 106, 1479
"d:\panling\yuehua-plugin\src\main\java\com\xiaoxiaoowo\yuehua\items\zhuangbei\Shipin.java", "Java", 0, 2202, 0, 181, 2383
"d:\panling\yuehua-plugin\src\main\java\com\xiaoxiaoowo\yuehua\items\zhuangbei\Weapon.java", "Java", 0, 1557, 10, 76, 1643
"d:\panling\yuehua-plugin\src\main\java\com\xiaoxiaoowo\yuehua\items\zhuangbei\YiQi.java", "Java", 0, 624, 3, 51, 678
"d:\panling\yuehua-plugin\src\main\java\com\xiaoxiaoowo\yuehua\itemstack\Book.java", "Java", 0, -321, 0, -41, -362
"d:\panling\yuehua-plugin\src\main\java\com\xiaoxiaoowo\yuehua\itemstack\dz\Core.java", "Java", 0, -3685, -61, -703, -4449
"d:\panling\yuehua-plugin\src\main\java\com\xiaoxiaoowo\yuehua\itemstack\dz\FuLing.java", "Java", 0, -862, -13, -89, -964
"d:\panling\yuehua-plugin\src\main\java\com\xiaoxiaoowo\yuehua\itemstack\dz\Ingredient.java", "Java", 0, -885, -29, -96, -1010
"d:\panling\yuehua-plugin\src\main\java\com\xiaoxiaoowo\yuehua\itemstack\dz\TehuaShui.java", "Java", 0, -316, 0, -82, -398
"d:\panling\yuehua-plugin\src\main\java\com\xiaoxiaoowo\yuehua\itemstack\dz\YuShi.java", "Java", 0, -1575, -13, -173, -1761
"d:\panling\yuehua-plugin\src\main\java\com\xiaoxiaoowo\yuehua\itemstack\dz\YuanSu.java", "Java", 0, -213, -4, -31, -248
"d:\panling\yuehua-plugin\src\main\java\com\xiaoxiaoowo\yuehua\itemstack\liandan\Dan.java", "Java", 0, -78, -1, -19, -98
"d:\panling\yuehua-plugin\src\main\java\com\xiaoxiaoowo\yuehua\itemstack\liandan\Herb.java", "Java", 0, -196, -4, -24, -224
"d:\panling\yuehua-plugin\src\main\java\com\xiaoxiaoowo\yuehua\itemstack\monsterzhuangbei\Boot.java", "Java", 0, -177, 0, -30, -207
"d:\panling\yuehua-plugin\src\main\java\com\xiaoxiaoowo\yuehua\itemstack\monsterzhuangbei\Bow.java", "Java", 0, -71, 0, -19, -90
"d:\panling\yuehua-plugin\src\main\java\com\xiaoxiaoowo\yuehua\itemstack\monsterzhuangbei\Chest.java", "Java", 0, -177, 0, -31, -208
"d:\panling\yuehua-plugin\src\main\java\com\xiaoxiaoowo\yuehua\itemstack\monsterzhuangbei\Helmet.java", "Java", 0, -109, 0, -27, -136
"d:\panling\yuehua-plugin\src\main\java\com\xiaoxiaoowo\yuehua\itemstack\monsterzhuangbei\Leg.java", "Java", 0, -93, 0, -29, -122
"d:\panling\yuehua-plugin\src\main\java\com\xiaoxiaoowo\yuehua\itemstack\monsterzhuangbei\Weapon.java", "Java", 0, -469, -23, -144, -636
"d:\panling\yuehua-plugin\src\main\java\com\xiaoxiaoowo\yuehua\itemstack\other\Collection.java", "Java", 0, -157, 0, -28, -185
"d:\panling\yuehua-plugin\src\main\java\com\xiaoxiaoowo\yuehua\itemstack\other\Feather.java", "Java", 0, -225, 0, -26, -251
"d:\panling\yuehua-plugin\src\main\java\com\xiaoxiaoowo\yuehua\itemstack\other\Food.java", "Java", 0, -642, -7, -63, -712
"d:\panling\yuehua-plugin\src\main\java\com\xiaoxiaoowo\yuehua\itemstack\other\FuBen.java", "Java", 0, -140, -2, -17, -159
"d:\panling\yuehua-plugin\src\main\java\com\xiaoxiaoowo\yuehua\itemstack\other\Money.java", "Java", 0, -94, 0, -22, -116
"d:\panling\yuehua-plugin\src\main\java\com\xiaoxiaoowo\yuehua\itemstack\other\MoneyLoot.java", "Java", 0, -202, -6, -55, -263
"d:\panling\yuehua-plugin\src\main\java\com\xiaoxiaoowo\yuehua\itemstack\other\Other.java", "Java", 0, -47, 0, -13, -60
"d:\panling\yuehua-plugin\src\main\java\com\xiaoxiaoowo\yuehua\itemstack\other\RaceProvince.java", "Java", 0, -86, 0, -25, -111
"d:\panling\yuehua-plugin\src\main\java\com\xiaoxiaoowo\yuehua\itemstack\other\XP.java", "Java", 0, -105, -1, -21, -127
"d:\panling\yuehua-plugin\src\main\java\com\xiaoxiaoowo\yuehua\itemstack\zhuangbei\ArmorChest.java", "Java", 0, -979, -4, -28, -1011
"d:\panling\yuehua-plugin\src\main\java\com\xiaoxiaoowo\yuehua\itemstack\zhuangbei\ArmorFeet.java", "Java", 0, -958, -4, -28, -990
"d:\panling\yuehua-plugin\src\main\java\com\xiaoxiaoowo\yuehua\itemstack\zhuangbei\ArmorHead.java", "Java", 0, -967, -4, -57, -1028
"d:\panling\yuehua-plugin\src\main\java\com\xiaoxiaoowo\yuehua\itemstack\zhuangbei\ArmorLeg.java", "Java", 0, -970, -4, -32, -1006
"d:\panling\yuehua-plugin\src\main\java\com\xiaoxiaoowo\yuehua\itemstack\zhuangbei\BiWeapon.java", "Java", 0, -690, -3, -56, -749
"d:\panling\yuehua-plugin\src\main\java\com\xiaoxiaoowo\yuehua\itemstack\zhuangbei\Fabao.java", "Java", 0, -1304, -12, -96, -1412
"d:\panling\yuehua-plugin\src\main\java\com\xiaoxiaoowo\yuehua\itemstack\zhuangbei\Shipin.java", "Java", 0, -2133, 0, -170, -2303
"d:\panling\yuehua-plugin\src\main\java\com\xiaoxiaoowo\yuehua\itemstack\zhuangbei\Weapon.java", "Java", 0, -1363, -10, -65, -1438
"d:\panling\yuehua-plugin\src\main\java\com\xiaoxiaoowo\yuehua\itemstack\zhuangbei\YiQi.java", "Java", 0, -597, -3, -49, -649
"d:\panling\yuehua-plugin\src\main\java\com\xiaoxiaoowo\yuehua\jineng\DoJiNeng.java", "Java", 0, 173, 0, 25, 198
"d:\panling\yuehua-plugin\src\main\java\com\xiaoxiaoowo\yuehua\jineng\dan\zhenfa\Huo.java", "Java", 0, 29, 0, 10, 39
"d:\panling\yuehua-plugin\src\main\java\com\xiaoxiaoowo\yuehua\jineng\dan\zhenfa\Jin.java", "Java", 0, 46, 0, 18, 64
"d:\panling\yuehua-plugin\src\main\java\com\xiaoxiaoowo\yuehua\jineng\dan\zhenfa\Mu.java", "Java", 0, 24, 0, 10, 34
"d:\panling\yuehua-plugin\src\main\java\com\xiaoxiaoowo\yuehua\jineng\dan\zhenfa\Shui.java", "Java", 0, 28, 0, 10, 38
"d:\panling\yuehua-plugin\src\main\java\com\xiaoxiaoowo\yuehua\jineng\dan\zhenfa\Tu.java", "Java", 0, 22, 0, 9, 31
"d:\panling\yuehua-plugin\src\main\java\com\xiaoxiaoowo\yuehua\jineng\gong\weapon\juji\BeiDouMieShenGong.java", "Java", 0, 19, 0, 5, 24
"d:\panling\yuehua-plugin\src\main\java\com\xiaoxiaoowo\yuehua\jineng\gong\weapon\juji\QinTongGong.java", "Java", 0, 19, 0, 4, 23
"d:\panling\yuehua-plugin\src\main\java\com\xiaoxiaoowo\yuehua\jineng\gong\weapon\juji\TengMuGong.java", "Java", 0, 19, 0, 4, 23
"d:\panling\yuehua-plugin\src\main\java\com\xiaoxiaoowo\yuehua\jineng\gong\weapon\juji\YanTieGong.java", "Java", 0, 19, 0, 4, 23
"d:\panling\yuehua-plugin\src\main\java\com\xiaoxiaoowo\yuehua\jineng\gong\weapon\juji\ZhongChuiGong.java", "Java", 0, 19, 0, 4, 23
"d:\panling\yuehua-plugin\src\main\java\com\xiaoxiaoowo\yuehua\jineng\gong\weapon\lingjian\FuRongGong.java", "Java", 0, 25, 0, 7, 32
"d:\panling\yuehua-plugin\src\main\java\com\xiaoxiaoowo\yuehua\jineng\gong\weapon\lingjian\HongLuanGong.java", "Java", 0, 26, 0, 5, 31
"d:\panling\yuehua-plugin\src\main\java\com\xiaoxiaoowo\yuehua\jineng\gong\weapon\lingjian\SheTianZhuiYueGong.java", "Java", 0, 25, 0, 5, 30
"d:\panling\yuehua-plugin\src\main\java\com\xiaoxiaoowo\yuehua\jineng\gong\weapon\lingjian\TianQiongGong.java", "Java", 0, 25, 0, 4, 29
"d:\panling\yuehua-plugin\src\main\java\com\xiaoxiaoowo\yuehua\jineng\gong\weapon\youxia\HeiTieNu.java", "Java", 0, 24, 0, 5, 29
"d:\panling\yuehua-plugin\src\main\java\com\xiaoxiaoowo\yuehua\jineng\gong\weapon\youxia\HongLinNu.java", "Java", 0, 24, 0, 5, 29
"d:\panling\yuehua-plugin\src\main\java\com\xiaoxiaoowo\yuehua\jineng\gong\weapon\youxia\JiaoLongNu.java", "Java", 0, 48, 0, 7, 55
"d:\panling\yuehua-plugin\src\main\java\com\xiaoxiaoowo\yuehua\jineng\gong\weapon\youxia\RiYueLiuXinNu.java", "Java", 0, 16, 0, 5, 21
"d:\panling\yuehua-plugin\src\main\java\com\xiaoxiaoowo\yuehua\jineng\zhan\weapon\jinzhong\ChiTongJian.java", "Java", 0, 37, 0, 7, 44
"d:\panling\yuehua-plugin\src\main\java\com\xiaoxiaoowo\yuehua\jineng\zhan\weapon\jinzhong\KunLunFeiXianJian.java", "Java", 0, 59, 0, 12, 71
"d:\panling\yuehua-plugin\src\main\java\com\xiaoxiaoowo\yuehua\jineng\zhan\weapon\jinzhong\QinTongJian.java", "Java", 0, 28, 0, 6, 34
"d:\panling\yuehua-plugin\src\main\java\com\xiaoxiaoowo\yuehua\jineng\zhan\weapon\jinzhong\TaiJiJian.java", "Java", 0, 42, 1, 7, 50
"d:\panling\yuehua-plugin\src\main\java\com\xiaoxiaoowo\yuehua\jineng\zhan\weapon\pojun\JinGuaChui.java", "Java", 0, 19, 0, 4, 23
"d:\panling\yuehua-plugin\src\main\java\com\xiaoxiaoowo\yuehua\jineng\zhan\weapon\pojun\KaiShanDao.java", "Java", 0, 19, 0, 4, 23
"d:\panling\yuehua-plugin\src\main\java\com\xiaoxiaoowo\yuehua\jineng\zhan\weapon\pojun\PoKongFu.java", "Java", 0, 19, 0, 4, 23
"d:\panling\yuehua-plugin\src\main\java\com\xiaoxiaoowo\yuehua\jineng\zhan\weapon\pojun\SanBaoYuRuYi.java", "Java", 0, 19, 0, 4, 23
"d:\panling\yuehua-plugin\src\main\java\com\xiaoxiaoowo\yuehua\jineng\zhan\weapon\pojun\TaoMuJian.java", "Java", 0, 29, 0, 6, 35
"d:\panling\yuehua-plugin\src\main\java\com\xiaoxiaoowo\yuehua\jineng\zhan\weapon\tanyun\HongYinQiang.java", "Java", 0, 38, 0, 12, 50
"d:\panling\yuehua-plugin\src\main\java\com\xiaoxiaoowo\yuehua\jineng\zhan\weapon\tanyun\HuTouZhanJinQiang.java", "Java", 0, 51, 0, 15, 66
"d:\panling\yuehua-plugin\src\main\java\com\xiaoxiaoowo\yuehua\jineng\zhan\weapon\tanyun\YinYueQiang.java", "Java", 0, 28, 0, 9, 37
"d:\panling\yuehua-plugin\src\main\java\com\xiaoxiaoowo\yuehua\jineng\zhan\weapon\tanyun\YouLongQiang.java", "Java", 0, 51, 0, 10, 61
"d:\panling\yuehua-plugin\src\main\java\com\xiaoxiaoowo\yuehua\shilian\huancheng\HuanCheng.java", "Java", 0, 14, 0, 2, 16
"d:\panling\yuehua-plugin\src\main\java\com\xiaoxiaoowo\yuehua\system\Act.java", "Java", 0, 2, 0, 4, 6
"d:\panling\yuehua-plugin\src\main\java\com\xiaoxiaoowo\yuehua\system\Buff.java", "Java", 0, 600, 0, 66, 666
"d:\panling\yuehua-plugin\src\main\java\com\xiaoxiaoowo\yuehua\system\Cure.java", "Java", 0, 23, 1, 3, 27
"d:\panling\yuehua-plugin\src\main\java\com\xiaoxiaoowo\yuehua\system\Damage.java", "Java", 0, 160, 10, 59, 229
"d:\panling\yuehua-plugin\src\main\java\com\xiaoxiaoowo\yuehua\system\DataContainer.java", "Java", 0, 63, 5, 20, 88
"d:\panling\yuehua-plugin\src\main\java\com\xiaoxiaoowo\yuehua\system\DoJiNeng.java", "Java", 0, -143, 0, -53, -196
"d:\panling\yuehua-plugin\src\main\java\com\xiaoxiaoowo\yuehua\system\Init.java", "Java", 0, 8, 0, 3, 11
"d:\panling\yuehua-plugin\src\main\java\com\xiaoxiaoowo\yuehua\system\Team.java", "Java", 0, 6, 0, 0, 6
"d:\panling\yuehua-plugin\src\main\java\com\xiaoxiaoowo\yuehua\system\act\ActFuling.java", "Java", 0, -1, 0, 0, -1
"d:\panling\yuehua-plugin\src\main\java\com\xiaoxiaoowo\yuehua\system\handleMonsters\DoMonsterAttack.java", "Java", 0, 33, 0, 10, 43
"d:\panling\yuehua-plugin\src\main\java\com\xiaoxiaoowo\yuehua\system\handleMonsters\DoMonsterAttacked.java", "Java", 0, 21, 0, 7, 28
"d:\panling\yuehua-plugin\src\main\java\com\xiaoxiaoowo\yuehua\system\handleMonsters\DoMonsterWuLiAttacked.java", "Java", 0, 52, 0, 10, 62
"d:\panling\yuehua-plugin\src\main\java\com\xiaoxiaoowo\yuehua\system\handleObsevers\DoAttackObserver.java", "Java", 0, 180, 1, 19, 200
"d:\panling\yuehua-plugin\src\main\java\com\xiaoxiaoowo\yuehua\system\handleObsevers\DoAttackedObserver.java", "Java", 0, 84, 0, 17, 101
"d:\panling\yuehua-plugin\src\main\java\com\xiaoxiaoowo\yuehua\system\handleObsevers\DoBaojiObserver.java", "Java", 0, 1, 0, 0, 1
"d:\panling\yuehua-plugin\src\main\java\com\xiaoxiaoowo\yuehua\system\handleObsevers\DoHitObserver.java", "Java", 0, 145, 0, 32, 177
"d:\panling\yuehua-plugin\src\main\java\com\xiaoxiaoowo\yuehua\system\handleObsevers\DoJiNengObservers.java", "Java", 0, 24, 1, 4, 29
"d:\panling\yuehua-plugin\src\main\java\com\xiaoxiaoowo\yuehua\system\handleObsevers\DoKillMonsterObserver.java", "Java", 0, 67, 0, 22, 89
"d:\panling\yuehua-plugin\src\main\java\com\xiaoxiaoowo\yuehua\system\handleObsevers\DoPlayerProjectileObserver.java", "Java", 0, 435, 3, 65, 503
"d:\panling\yuehua-plugin\src\main\java\com\xiaoxiaoowo\yuehua\system\handleObsevers\DoZhenfaObserver.java", "Java", 0, 22, 1, 7, 30
"d:\panling\yuehua-plugin\src\main\java\com\xiaoxiaoowo\yuehua\system\handlePets\DoPetDeath.java", "Java", 0, 10, 0, -1, 9
"d:\panling\yuehua-plugin\src\main\java\com\xiaoxiaoowo\yuehua\task\check\DayOfWeek.java", "Java", 0, 29, 0, 6, 35
"d:\panling\yuehua-plugin\src\main\java\com\xiaoxiaoowo\yuehua\task\check\Fulong.java", "Java", 0, 29, 0, 6, 35
"d:\panling\yuehua-plugin\src\main\java\com\xiaoxiaoowo\yuehua\task\check\Month.java", "Java", 0, 29, 0, 6, 35
"d:\panling\yuehua-plugin\src\main\java\com\xiaoxiaoowo\yuehua\task\check\Num.java", "Java", 0, 31, 0, 8, 39
"d:\panling\yuehua-plugin\src\main\java\com\xiaoxiaoowo\yuehua\task\check\Xiaoxiao.java", "Java", 0, 29, 0, 6, 35
"d:\panling\yuehua-plugin\src\main\java\com\xiaoxiaoowo\yuehua\task\check\Year.java", "Java", 0, 29, 0, 6, 35
"d:\panling\yuehua-plugin\src\main\java\com\xiaoxiaoowo\yuehua\task\hujia\Xie1.java", "Java", 0, 4, 0, -1, 3
"d:\panling\yuehua-plugin\src\main\java\com\xiaoxiaoowo\yuehua\task\hujia\Xie2345.java", "Java", 0, 4, 0, 3, 7
"d:\panling\yuehua-plugin\src\main\java\com\xiaoxiaoowo\yuehua\task\hujia\Xiong1.java", "Java", 0, 3, 0, 3, 6
"d:\panling\yuehua-plugin\src\main\java\com\xiaoxiaoowo\yuehua\task\hujia\Xiong2345.java", "Java", 0, 4, 0, 3, 7
"d:\panling\yuehua-plugin\src\main\java\com\xiaoxiaoowo\yuehua\task\other\ContinueLineDamage.java", "Java", 0, 36, 0, 9, 45
"d:\panling\yuehua-plugin\src\main\java\com\xiaoxiaoowo\yuehua\task\other\ContinueRangeDamage.java", "Java", 0, 38, 0, 8, 46
"d:\panling\yuehua-plugin\src\main\java\com\xiaoxiaoowo\yuehua\task\other\ContinuedLoseHp.java", "Java", 0, 40, 0, 13, 53
"d:\panling\yuehua-plugin\src\main\java\com\xiaoxiaoowo\yuehua\task\other\DrawProjectile.java", "Java", 0, 60, 0, 14, 74
"d:\panling\yuehua-plugin\src\main\java\com\xiaoxiaoowo\yuehua\task\other\LandDu.java", "Java", 0, 29, 1, 8, 38
"d:\panling\yuehua-plugin\src\main\java\com\xiaoxiaoowo\yuehua\task\other\ReflectProjectile.java", "Java", 0, 5, 0, 2, 7
"d:\panling\yuehua-plugin\src\main\java\com\xiaoxiaoowo\yuehua\task\other\ShuiDu.java", "Java", 0, 28, 1, 8, 37
"d:\panling\yuehua-plugin\src\main\java\com\xiaoxiaoowo\yuehua\task\player\BGM.java", "Java", 0, 18, 0, 6, 24
"d:\panling\yuehua-plugin\src\main\java\com\xiaoxiaoowo\yuehua\task\player\DisplayHp.java", "Java", 0, 101, 0, 25, 126
"d:\panling\yuehua-plugin\src\main\java\com\xiaoxiaoowo\yuehua\task\regainAttribute\RegainAttack.java", "Java", 0, 24, 0, 7, 31
"d:\panling\yuehua-plugin\src\main\java\com\xiaoxiaoowo\yuehua\task\regainAttribute\RegainFakang.java", "Java", 0, 24, 0, 7, 31
"d:\panling\yuehua-plugin\src\main\java\com\xiaoxiaoowo\yuehua\task\regainAttribute\RegainGedang.java", "Java", 0, 24, 0, 6, 30
"d:\panling\yuehua-plugin\src\main\java\com\xiaoxiaoowo\yuehua\task\regainAttribute\RegainHujia.java", "Java", 0, 24, 0, 6, 30
"d:\panling\yuehua-plugin\src\main\java\com\xiaoxiaoowo\yuehua\task\regainAttribute\RegainPofa.java", "Java", 0, 24, 0, 7, 31
"d:\panling\yuehua-plugin\src\main\java\com\xiaoxiaoowo\yuehua\task\regainAttribute\RegainPojia.java", "Java", 0, 24, 0, 8, 32
"d:\panling\yuehua-plugin\src\main\java\com\xiaoxiaoowo\yuehua\task\regainAttribute\RegainRenxing.java", "Java", 0, 24, 0, 6, 30
"d:\panling\yuehua-plugin\src\main\java\com\xiaoxiaoowo\yuehua\task\regainAttribute\RegainShengJi.java", "Java", 0, 24, 0, 7, 31
"d:\panling\yuehua-plugin\src\main\java\com\xiaoxiaoowo\yuehua\task\regainAttribute\XuanYun.java", "Java", 0, 24, 0, 8, 32
"d:\panling\yuehua-plugin\src\main\java\com\xiaoxiaoowo\yuehua\task\weapon\HongYinQiangFire.java", "Java", 0, 41, 0, 12, 53
"d:\panling\yuehua-plugin\src\main\java\com\xiaoxiaoowo\yuehua\task\weapon\SheTian.java", "Java", 0, 23, 1, 6, 30
"d:\panling\yuehua-plugin\src\main\java\com\xiaoxiaoowo\yuehua\task\weapon\YouLong.java", "Java", 0, 32, 0, 8, 40
"d:\panling\yuehua-plugin\src\main\java\com\xiaoxiaoowo\yuehua\task\weapon\YouLongShui.java", "Java", 0, 42, 1, 10, 53
"d:\panling\yuehua-plugin\src\main\java\com\xiaoxiaoowo\yuehua\task\yiqi\LAOZHANSHIDUNPAI.java", "Java", 0, 26, 0, 10, 36
"d:\panling\yuehua-plugin\src\main\java\com\xiaoxiaoowo\yuehua\utils\ComponentSet.java", "Java", 0, 1, 0, 1, 2
"d:\panling\yuehua-plugin\src\main\java\com\xiaoxiaoowo\yuehua\utils\GetEntity.java", "Java", 0, -12, 0, 1, -11
"d:\panling\yuehua-plugin\src\main\java\com\xiaoxiaoowo\yuehua\utils\LocationCheck.java", "Java", 0, -7, 7, 0, 0
"d:\panling\yuehua-plugin\src\main\java\com\xiaoxiaoowo\yuehua\utils\MoveEntity.java", "Java", 0, 123, 12, 30, 165
"d:\panling\yuehua-plugin\src\main\java\com\xiaoxiaoowo\yuehua\utils\MyLootTable.java", "Java", 0, -30, -1, -7, -38
"d:\panling\yuehua-plugin\src\main\java\com\xiaoxiaoowo\yuehua\utils\MySocket.java", "Java", 0, 46, 0, 7, 53
"d:\panling\yuehua-plugin\src\main\java\com\xiaoxiaoowo\yuehua\utils\PlaySound.java", "Java", 0, 12, 0, 4, 16
"d:\panling\yuehua-plugin\src\main\java\com\xiaoxiaoowo\yuehua\utils\RandomChest.java", "Java", 0, 137, 0, 16, 153
"d:\panling\yuehua-plugin\src\main\java\com\xiaoxiaoowo\yuehua\utils\SQL.java", "Java", 0, 33, 26, 1, 60
"d:\panling\yuehua-plugin\src\main\java\com\xiaoxiaoowo\yuehua\utils\SendInformation.java", "Java", 0, 1, 0, 1, 2
"d:\panling\yuehua-plugin\src\main\java\com\xiaoxiaoowo\yuehua\utils\Transfer.java", "Java", 0, -59, 0, -16, -75
"d:\panling\yuehua-plugin\src\main\java\com\xiaoxiaoowo\yuehua\utils\loot\MyLootTable.java", "Java", 0, 38, 0, 13, 51
"d:\panling\yuehua-plugin\src\main\java\com\xiaoxiaoowo\yuehua\utils\loot\NumItem.java", "Java", 0, 10, 0, 4, 14
"d:\panling\yuehua-plugin\src\main\java\com\xiaoxiaoowo\yuehua\utils\loot\ProItem.java", "Java", 0, 10, 0, 4, 14
"d:\panling\yuehua-plugin\src\main\resources\plugin.yml", "YAML", -4, 0, 0, 0, -4
"Total", "-", -4, 12105, 640, 2615, 15356