"filename", "language", "Markdown", "YAML", "Java", "JSON", "comment", "blank", "total"
"d:\panling\yuehua-plugin\src\.VSCodeCounter\2024-10-18_14-33-33\details.md", "Markdown", 223, 0, 0, 0, 0, 6, 229
"d:\panling\yuehua-plugin\src\.VSCodeCounter\2024-10-18_14-33-33\diff-details.md", "Markdown", 9, 0, 0, 0, 0, 6, 15
"d:\panling\yuehua-plugin\src\.VSCodeCounter\2024-10-18_14-33-33\diff.md", "Markdown", 12, 0, 0, 0, 0, 7, 19
"d:\panling\yuehua-plugin\src\.VSCodeCounter\2024-10-18_14-33-33\results.json", "JSON", 0, 0, 0, 1, 0, 0, 1
"d:\panling\yuehua-plugin\src\.VSCodeCounter\2024-10-18_14-33-33\results.md", "Markdown", 73, 0, 0, 0, 0, 7, 80
"d:\panling\yuehua-plugin\src\main\java\com\xiaoxiaoowo\yuehua\Yuehua.java", "Java", 0, 0, 286, 0, 39, 61, 386
"d:\panling\yuehua-plugin\src\main\java\com\xiaoxiaoowo\yuehua\attribute\AttributeSet.java", "Java", 0, 0, 1905, 0, 0, 307, 2212
"d:\panling\yuehua-plugin\src\main\java\com\xiaoxiaoowo\yuehua\attribute\attributes\MyAttribute.java", "Java", 0, 0, 8, 0, 0, 6, 14
"d:\panling\yuehua-plugin\src\main\java\com\xiaoxiaoowo\yuehua\attribute\attributes\fangyu\Fakang.java", "Java", 0, 0, 34, 0, 0, 7, 41
"d:\panling\yuehua-plugin\src\main\java\com\xiaoxiaoowo\yuehua\attribute\attributes\fangyu\Gedang.java", "Java", 0, 0, 34, 0, 0, 7, 41
"d:\panling\yuehua-plugin\src\main\java\com\xiaoxiaoowo\yuehua\attribute\attributes\fangyu\Hujia.java", "Java", 0, 0, 34, 0, 0, 7, 41
"d:\panling\yuehua-plugin\src\main\java\com\xiaoxiaoowo\yuehua\attribute\attributes\fangyu\Renxing.java", "Java", 0, 0, 34, 0, 0, 7, 41
"d:\panling\yuehua-plugin\src\main\java\com\xiaoxiaoowo\yuehua\attribute\attributes\fangyu\Shengji.java", "Java", 0, 0, 34, 0, 0, 7, 41
"d:\panling\yuehua-plugin\src\main\java\com\xiaoxiaoowo\yuehua\attribute\attributes\fangyu\ShouHu.java", "Java", 0, 0, 34, 0, 0, 7, 41
"d:\panling\yuehua-plugin\src\main\java\com\xiaoxiaoowo\yuehua\attribute\attributes\jingong\ArrowAdd.java", "Java", 0, 0, 43, 0, 0, 14, 57
"d:\panling\yuehua-plugin\src\main\java\com\xiaoxiaoowo\yuehua\attribute\attributes\jingong\ArrowMul.java", "Java", 0, 0, 43, 0, 0, 14, 57
"d:\panling\yuehua-plugin\src\main\java\com\xiaoxiaoowo\yuehua\attribute\attributes\jingong\AttackAdd.java", "Java", 0, 0, 40, 0, 0, 14, 54
"d:\panling\yuehua-plugin\src\main\java\com\xiaoxiaoowo\yuehua\attribute\attributes\jingong\AttackMul.java", "Java", 0, 0, 40, 0, 0, 13, 53
"d:\panling\yuehua-plugin\src\main\java\com\xiaoxiaoowo\yuehua\attribute\attributes\jingong\BaoJi.java", "Java", 0, 0, 34, 0, 0, 7, 41
"d:\panling\yuehua-plugin\src\main\java\com\xiaoxiaoowo\yuehua\attribute\attributes\jingong\BaojiXiaoguo.java", "Java", 0, 0, 34, 0, 0, 7, 41
"d:\panling\yuehua-plugin\src\main\java\com\xiaoxiaoowo\yuehua\attribute\attributes\jingong\CoolReduce.java", "Java", 0, 0, 34, 0, 0, 7, 41
"d:\panling\yuehua-plugin\src\main\java\com\xiaoxiaoowo\yuehua\attribute\attributes\jingong\CoolReduceUnlimited.java", "Java", 0, 0, 30, 0, 0, 7, 37
"d:\panling\yuehua-plugin\src\main\java\com\xiaoxiaoowo\yuehua\attribute\attributes\jingong\JinGongMul.java", "Java", 0, 0, 87, 0, 0, 31, 118
"d:\panling\yuehua-plugin\src\main\java\com\xiaoxiaoowo\yuehua\attribute\attributes\jingong\JingongAdd.java", "Java", 0, 0, 90, 0, 0, 29, 119
"d:\panling\yuehua-plugin\src\main\java\com\xiaoxiaoowo\yuehua\attribute\attributes\jingong\Pofa.java", "Java", 0, 0, 34, 0, 0, 7, 41
"d:\panling\yuehua-plugin\src\main\java\com\xiaoxiaoowo\yuehua\attribute\attributes\jingong\Pojia.java", "Java", 0, 0, 34, 0, 0, 7, 41
"d:\panling\yuehua-plugin\src\main\java\com\xiaoxiaoowo\yuehua\attribute\attributes\jingong\ZhenfaAdd.java", "Java", 0, 0, 43, 0, 0, 14, 57
"d:\panling\yuehua-plugin\src\main\java\com\xiaoxiaoowo\yuehua\attribute\attributes\jingong\ZhenfaMul.java", "Java", 0, 0, 43, 0, 0, 16, 59
"d:\panling\yuehua-plugin\src\main\java\com\xiaoxiaoowo\yuehua\attribute\attributes\special\ArrowCountMax.java", "Java", 0, 0, 30, 0, 0, 7, 37
"d:\panling\yuehua-plugin\src\main\java\com\xiaoxiaoowo\yuehua\attribute\attributes\special\Danlu.java", "Java", 0, 0, 41, 0, 0, 9, 50
"d:\panling\yuehua-plugin\src\main\java\com\xiaoxiaoowo\yuehua\attribute\attributes\special\IsBow.java", "Java", 0, 0, 25, 0, 0, 5, 30
"d:\panling\yuehua-plugin\src\main\java\com\xiaoxiaoowo\yuehua\attribute\attributes\special\SlotWithId.java", "Java", 0, 0, 117, 0, 0, 8, 125
"d:\panling\yuehua-plugin\src\main\java\com\xiaoxiaoowo\yuehua\attribute\attributes\vanilla\AttackRange.java", "Java", 0, 0, 35, 0, 0, 8, 43
"d:\panling\yuehua-plugin\src\main\java\com\xiaoxiaoowo\yuehua\attribute\attributes\vanilla\AttackSpeed.java", "Java", 0, 0, 35, 0, 0, 7, 42
"d:\panling\yuehua-plugin\src\main\java\com\xiaoxiaoowo\yuehua\attribute\attributes\vanilla\DingLi.java", "Java", 0, 0, 36, 0, 0, 8, 44
"d:\panling\yuehua-plugin\src\main\java\com\xiaoxiaoowo\yuehua\attribute\attributes\vanilla\Hp.java", "Java", 0, 0, 35, 0, 0, 7, 42
"d:\panling\yuehua-plugin\src\main\java\com\xiaoxiaoowo\yuehua\attribute\attributes\vanilla\HpMul.java", "Java", 0, 0, 54, 0, 0, 11, 65
"d:\panling\yuehua-plugin\src\main\java\com\xiaoxiaoowo\yuehua\attribute\attributes\vanilla\Jump.java", "Java", 0, 0, 37, 0, 0, 9, 46
"d:\panling\yuehua-plugin\src\main\java\com\xiaoxiaoowo\yuehua\attribute\attributes\vanilla\Speed.java", "Java", 0, 0, 56, 0, 0, 11, 67
"d:\panling\yuehua-plugin\src\main\java\com\xiaoxiaoowo\yuehua\commands\Test.java", "Java", 0, 0, 1043, 0, 659, 338, 2040
"d:\panling\yuehua-plugin\src\main\java\com\xiaoxiaoowo\yuehua\commands\blockcommand\Advancement.java", "Java", 0, 0, 11, 0, 0, 3, 14
"d:\panling\yuehua-plugin\src\main\java\com\xiaoxiaoowo\yuehua\commands\blockcommand\BlockTp.java", "Java", 0, 0, 42, 0, 0, 6, 48
"d:\panling\yuehua-plugin\src\main\java\com\xiaoxiaoowo\yuehua\commands\blockcommand\IntoGame.java", "Java", 0, 0, 222, 0, 13, 32, 267
"d:\panling\yuehua-plugin\src\main\java\com\xiaoxiaoowo\yuehua\commands\blockcommand\MarkRelife.java", "Java", 0, 0, 64, 0, 0, 8, 72
"d:\panling\yuehua-plugin\src\main\java\com\xiaoxiaoowo\yuehua\commands\blockcommand\MyBossSpawn.java", "Java", 0, 0, 63, 0, 0, 11, 74
"d:\panling\yuehua-plugin\src\main\java\com\xiaoxiaoowo\yuehua\commands\blockcommand\MySpawn.java", "Java", 0, 0, 73, 0, 0, 15, 88
"d:\panling\yuehua-plugin\src\main\java\com\xiaoxiaoowo\yuehua\commands\blockcommand\Relife.java", "Java", 0, 0, 123, 0, 1, 19, 143
"d:\panling\yuehua-plugin\src\main\java\com\xiaoxiaoowo\yuehua\commands\blockcommand\RenOu.java", "Java", 0, 0, 64, 0, 0, 10, 74
"d:\panling\yuehua-plugin\src\main\java\com\xiaoxiaoowo\yuehua\commands\blockcommand\RenOu2.java", "Java", 0, 0, 62, 0, 0, 8, 70
"d:\panling\yuehua-plugin\src\main\java\com\xiaoxiaoowo\yuehua\commands\blockcommand\RenOu3.java", "Java", 0, 0, 64, 0, 0, 8, 72
"d:\panling\yuehua-plugin\src\main\java\com\xiaoxiaoowo\yuehua\commands\blockcommand\Select.java", "Java", 0, 0, 165, 0, 1, 19, 185
"d:\panling\yuehua-plugin\src\main\java\com\xiaoxiaoowo\yuehua\commands\blockcommand\StoreRelifeStone.java", "Java", 0, 0, 59, 0, 0, 15, 74
"d:\panling\yuehua-plugin\src\main\java\com\xiaoxiaoowo\yuehua\commands\opcommand\A.java", "Java", 0, 0, 21, 0, 0, 4, 25
"d:\panling\yuehua-plugin\src\main\java\com\xiaoxiaoowo\yuehua\commands\opcommand\Check.java", "Java", 0, 0, 3, 0, 0, 2, 5
"d:\panling\yuehua-plugin\src\main\java\com\xiaoxiaoowo\yuehua\commands\opcommand\Clearup.java", "Java", 0, 0, 63, 0, 0, 9, 72
"d:\panling\yuehua-plugin\src\main\java\com\xiaoxiaoowo\yuehua\commands\opcommand\FixLore.java", "Java", 0, 0, 23, 0, 0, 4, 27
"d:\panling\yuehua-plugin\src\main\java\com\xiaoxiaoowo\yuehua\commands\opcommand\GI.java", "Java", 0, 0, 966, 0, 134, 95, 1195
"d:\panling\yuehua-plugin\src\main\java\com\xiaoxiaoowo\yuehua\commands\opcommand\MySave.java", "Java", 0, 0, 23, 0, 0, 4, 27
"d:\panling\yuehua-plugin\src\main\java\com\xiaoxiaoowo\yuehua\commands\opcommand\MyTp.java", "Java", 0, 0, 98, 0, 0, 6, 104
"d:\panling\yuehua-plugin\src\main\java\com\xiaoxiaoowo\yuehua\commands\opcommand\MyTpTab.java", "Java", 0, 0, 26, 0, 0, 6, 32
"d:\panling\yuehua-plugin\src\main\java\com\xiaoxiaoowo\yuehua\commands\opcommand\PerGet.java", "Java", 0, 0, 55, 0, 0, 13, 68
"d:\panling\yuehua-plugin\src\main\java\com\xiaoxiaoowo\yuehua\commands\opcommand\R.java", "Java", 0, 0, 21, 0, 0, 4, 25
"d:\panling\yuehua-plugin\src\main\java\com\xiaoxiaoowo\yuehua\commands\opcommand\SetSign.java", "Java", 0, 0, 45, 0, 0, 14, 59
"d:\panling\yuehua-plugin\src\main\java\com\xiaoxiaoowo\yuehua\commands\opcommand\Summon.java", "Java", 0, 0, 130, 0, 0, 4, 134
"d:\panling\yuehua-plugin\src\main\java\com\xiaoxiaoowo\yuehua\commands\opcommand\data\DataCountGet.java", "Java", 0, 0, 29, 0, 0, 5, 34
"d:\panling\yuehua-plugin\src\main\java\com\xiaoxiaoowo\yuehua\commands\opcommand\data\DataGet.java", "Java", 0, 0, 38, 0, 0, 5, 43
"d:\panling\yuehua-plugin\src\main\java\com\xiaoxiaoowo\yuehua\commands\opcommand\data\DataSet.java", "Java", 0, 0, 53, 0, 0, 23, 76
"d:\panling\yuehua-plugin\src\main\java\com\xiaoxiaoowo\yuehua\commands\opcommand\data\ItemDataGet.java", "Java", 0, 0, 43, 0, 0, 7, 50
"d:\panling\yuehua-plugin\src\main\java\com\xiaoxiaoowo\yuehua\commands\playercommand\ArrowCMD.java", "Java", 0, 0, 173, 0, 0, 28, 201
"d:\panling\yuehua-plugin\src\main\java\com\xiaoxiaoowo\yuehua\commands\playercommand\Buy.java", "Java", 0, 0, 82, 0, 0, 16, 98
"d:\panling\yuehua-plugin\src\main\java\com\xiaoxiaoowo\yuehua\commands\playercommand\Check.java", "Java", 0, 0, 102, 0, 0, 20, 122
"d:\panling\yuehua-plugin\src\main\java\com\xiaoxiaoowo\yuehua\commands\playercommand\Kill.java", "Java", 0, 0, 14, 0, 0, 3, 17
"d:\panling\yuehua-plugin\src\main\java\com\xiaoxiaoowo\yuehua\commands\playercommand\MoneyCMD.java", "Java", 0, 0, 416, 0, 2, 62, 480
"d:\panling\yuehua-plugin\src\main\java\com\xiaoxiaoowo\yuehua\commands\playercommand\Sale.java", "Java", 0, 0, 98, 0, 0, 23, 121
"d:\panling\yuehua-plugin\src\main\java\com\xiaoxiaoowo\yuehua\commands\playercommand\Sell.java", "Java", 0, 0, 137, 0, 1, 27, 165
"d:\panling\yuehua-plugin\src\main\java\com\xiaoxiaoowo\yuehua\commands\playercommand\Yhteam.java", "Java", 0, 0, 300, 0, 0, 73, 373
"d:\panling\yuehua-plugin\src\main\java\com\xiaoxiaoowo\yuehua\commands\playercommand\YuanSuCMD.java", "Java", 0, 0, 1027, 0, 0, 26, 1053
"d:\panling\yuehua-plugin\src\main\java\com\xiaoxiaoowo\yuehua\commands\playercommand\completer\ArrowCom.java", "Java", 0, 0, 27, 0, 0, 7, 34
"d:\panling\yuehua-plugin\src\main\java\com\xiaoxiaoowo\yuehua\commands\playercommand\completer\BuyCom.java", "Java", 0, 0, 18, 0, 0, 4, 22
"d:\panling\yuehua-plugin\src\main\java\com\xiaoxiaoowo\yuehua\commands\playercommand\completer\Check.java", "Java", 0, 0, 16, 0, 0, 4, 20
"d:\panling\yuehua-plugin\src\main\java\com\xiaoxiaoowo\yuehua\commands\playercommand\completer\MoneyCom.java", "Java", 0, 0, 41, 0, 0, 13, 54
"d:\panling\yuehua-plugin\src\main\java\com\xiaoxiaoowo\yuehua\commands\playercommand\completer\SaleCom.java", "Java", 0, 0, 21, 0, 0, 4, 25
"d:\panling\yuehua-plugin\src\main\java\com\xiaoxiaoowo\yuehua\commands\playercommand\completer\SellCom.java", "Java", 0, 0, 21, 0, 0, 4, 25
"d:\panling\yuehua-plugin\src\main\java\com\xiaoxiaoowo\yuehua\commands\playercommand\completer\Yhteam.java", "Java", 0, 0, 33, 0, 0, 9, 42
"d:\panling\yuehua-plugin\src\main\java\com\xiaoxiaoowo\yuehua\commands\playercommand\completer\YuanSuCom.java", "Java", 0, 0, 35, 0, 0, 8, 43
"d:\panling\yuehua-plugin\src\main\java\com\xiaoxiaoowo\yuehua\data\DanData.java", "Java", 0, 0, 124, 0, 1, 40, 165
"d:\panling\yuehua-plugin\src\main\java\com\xiaoxiaoowo\yuehua\data\Data.java", "Java", 0, 0, 1001, 0, 46, 240, 1287
"d:\panling\yuehua-plugin\src\main\java\com\xiaoxiaoowo\yuehua\data\GongData.java", "Java", 0, 0, 78, 0, 8, 26, 112
"d:\panling\yuehua-plugin\src\main\java\com\xiaoxiaoowo\yuehua\data\MonsterData.java", "Java", 0, 0, 110, 0, 0, 35, 145
"d:\panling\yuehua-plugin\src\main\java\com\xiaoxiaoowo\yuehua\data\PetData.java", "Java", 0, 0, 38, 0, 0, 14, 52
"d:\panling\yuehua-plugin\src\main\java\com\xiaoxiaoowo\yuehua\data\ZhanData.java", "Java", 0, 0, 19, 0, 1, 12, 32
"d:\panling\yuehua-plugin\src\main\java\com\xiaoxiaoowo\yuehua\data\slot\EnderChestSlot.java", "Java", 0, 0, 12, 0, 0, 4, 16
"d:\panling\yuehua-plugin\src\main\java\com\xiaoxiaoowo\yuehua\data\slot\Slot.java", "Java", 0, 0, 12, 0, 0, 9, 21
"d:\panling\yuehua-plugin\src\main\java\com\xiaoxiaoowo\yuehua\data\slot\SlotBuilder.java", "Java", 0, 0, 122, 0, 0, 34, 156
"d:\panling\yuehua-plugin\src\main\java\com\xiaoxiaoowo\yuehua\data\slot\SlotWithOneActiveSkill.java", "Java", 0, 0, 14, 0, 0, 8, 22
"d:\panling\yuehua-plugin\src\main\java\com\xiaoxiaoowo\yuehua\data\slot\SlotWithTwoActiveSkill.java", "Java", 0, 0, 17, 0, 0, 6, 23
"d:\panling\yuehua-plugin\src\main\java\com\xiaoxiaoowo\yuehua\data\slot\special\BeiDouMieShen.java", "Java", 0, 0, 15, 0, 0, 4, 19
"d:\panling\yuehua-plugin\src\main\java\com\xiaoxiaoowo\yuehua\display\test\TestDisplay.java", "Java", 0, 0, 127, 0, 3, 20, 150
"d:\panling\yuehua-plugin\src\main\java\com\xiaoxiaoowo\yuehua\display\test\TestRay.java", "Java", 0, 0, 30, 0, 5, 11, 46
"d:\panling\yuehua-plugin\src\main\java\com\xiaoxiaoowo\yuehua\display\utils\DisPlayUtils.java", "Java", 0, 0, 277, 0, 69, 95, 441
"d:\panling\yuehua-plugin\src\main\java\com\xiaoxiaoowo\yuehua\display\utils\ParticleUtils.java", "Java", 0, 0, 348, 0, 62, 105, 515
"d:\panling\yuehua-plugin\src\main\java\com\xiaoxiaoowo\yuehua\entity\monster\east\boss\JIANXIGUIMEI.java", "Java", 0, 0, 44, 0, 25, 22, 91
"d:\panling\yuehua-plugin\src\main\java\com\xiaoxiaoowo\yuehua\entity\monster\east\boss\LinYouDuZhu.java", "Java", 0, 0, 29, 0, 21, 17, 67
"d:\panling\yuehua-plugin\src\main\java\com\xiaoxiaoowo\yuehua\entity\monster\east\boss\ZHIZHUNVWANG.java", "Java", 0, 0, 29, 0, 9, 11, 49
"d:\panling\yuehua-plugin\src\main\java\com\xiaoxiaoowo\yuehua\entity\monster\east\normal\ChiJianJiangShi.java", "Java", 0, 0, 51, 0, 25, 21, 97
"d:\panling\yuehua-plugin\src\main\java\com\xiaoxiaoowo\yuehua\entity\monster\east\normal\DuFeng.java", "Java", 0, 0, 28, 0, 21, 17, 66
"d:\panling\yuehua-plugin\src\main\java\com\xiaoxiaoowo\yuehua\entity\monster\east\normal\JiangShi.java", "Java", 0, 0, 43, 0, 25, 20, 88
"d:\panling\yuehua-plugin\src\main\java\com\xiaoxiaoowo\yuehua\entity\monster\east\normal\KuGuGongJianShou.java", "Java", 0, 0, 50, 0, 25, 21, 96
"d:\panling\yuehua-plugin\src\main\java\com\xiaoxiaoowo\yuehua\entity\monster\east\normal\KuLou.java", "Java", 0, 0, 42, 0, 25, 21, 88
"d:\panling\yuehua-plugin\src\main\java\com\xiaoxiaoowo\yuehua\entity\monster\east\normal\ZhiZhu.java", "Java", 0, 0, 28, 0, 21, 20, 69
"d:\panling\yuehua-plugin\src\main\java\com\xiaoxiaoowo\yuehua\entity\monster\east\normal\ZhiZhuJinYin.java", "Java", 0, 0, 28, 0, 21, 18, 67
"d:\panling\yuehua-plugin\src\main\java\com\xiaoxiaoowo\yuehua\entity\monster\east\special\ShanshenShooter.java", "Java", 0, 0, 50, 0, 25, 20, 95
"d:\panling\yuehua-plugin\src\main\java\com\xiaoxiaoowo\yuehua\entity\monster\east\special\ShanshenSpider.java", "Java", 0, 0, 28, 0, 21, 17, 66
"d:\panling\yuehua-plugin\src\main\java\com\xiaoxiaoowo\yuehua\entity\monster\east\special\ShanshenZombie.java", "Java", 0, 0, 51, 0, 25, 21, 97
"d:\panling\yuehua-plugin\src\main\java\com\xiaoxiaoowo\yuehua\entity\monster\east\special\YaoJinShooter.java", "Java", 0, 0, 50, 0, 25, 21, 96
"d:\panling\yuehua-plugin\src\main\java\com\xiaoxiaoowo\yuehua\entity\monster\east\special\YaoJingMiFeng.java", "Java", 0, 0, 28, 0, 21, 18, 67
"d:\panling\yuehua-plugin\src\main\java\com\xiaoxiaoowo\yuehua\entity\monster\east\special\YaoJingPanda.java", "Java", 0, 0, 29, 0, 21, 18, 68
"d:\panling\yuehua-plugin\src\main\java\com\xiaoxiaoowo\yuehua\entity\monster\other\Renou.java", "Java", 0, 0, 54, 0, 17, 17, 88
"d:\panling\yuehua-plugin\src\main\java\com\xiaoxiaoowo\yuehua\entity\monster\other\Renou2.java", "Java", 0, 0, 56, 0, 17, 17, 90
"d:\panling\yuehua-plugin\src\main\java\com\xiaoxiaoowo\yuehua\entity\monster\other\Renou3.java", "Java", 0, 0, 59, 0, 17, 18, 94
"d:\panling\yuehua-plugin\src\main\java\com\xiaoxiaoowo\yuehua\entity\monster\other\TemplateMonster.java", "Java", 0, 0, 53, 0, 25, 21, 99
"d:\panling\yuehua-plugin\src\main\java\com\xiaoxiaoowo\yuehua\entity\monster\other\TemplateShooter.java", "Java", 0, 0, 54, 0, 13, 15, 82
"d:\panling\yuehua-plugin\src\main\java\com\xiaoxiaoowo\yuehua\entity\npc\dz\ArmorChest.java", "Java", 0, 0, 186, 0, 4, 36, 226
"d:\panling\yuehua-plugin\src\main\java\com\xiaoxiaoowo\yuehua\entity\npc\dz\ArmorFeet.java", "Java", 0, 0, 186, 0, 4, 35, 225
"d:\panling\yuehua-plugin\src\main\java\com\xiaoxiaoowo\yuehua\entity\npc\dz\ArmorHead.java", "Java", 0, 0, 186, 0, 4, 37, 227
"d:\panling\yuehua-plugin\src\main\java\com\xiaoxiaoowo\yuehua\entity\npc\dz\ArmorLeg.java", "Java", 0, 0, 186, 0, 4, 36, 226
"d:\panling\yuehua-plugin\src\main\java\com\xiaoxiaoowo\yuehua\entity\npc\dz\BiWeapon.java", "Java", 0, 0, 158, 0, 4, 26, 188
"d:\panling\yuehua-plugin\src\main\java\com\xiaoxiaoowo\yuehua\entity\npc\dz\DUShipin.java", "Java", 0, 0, 158, 0, 4, 26, 188
"d:\panling\yuehua-plugin\src\main\java\com\xiaoxiaoowo\yuehua\entity\npc\dz\DanWeapon.java", "Java", 0, 0, 86, 0, 4, 21, 111
"d:\panling\yuehua-plugin\src\main\java\com\xiaoxiaoowo\yuehua\entity\npc\dz\Fabao1.java", "Java", 0, 0, 119, 0, 4, 24, 147
"d:\panling\yuehua-plugin\src\main\java\com\xiaoxiaoowo\yuehua\entity\npc\dz\Fabao2.java", "Java", 0, 0, 119, 0, 4, 24, 147
"d:\panling\yuehua-plugin\src\main\java\com\xiaoxiaoowo\yuehua\entity\npc\dz\Fabao3.java", "Java", 0, 0, 119, 0, 4, 24, 147
"d:\panling\yuehua-plugin\src\main\java\com\xiaoxiaoowo\yuehua\entity\npc\dz\GongWeapon.java", "Java", 0, 0, 158, 0, 4, 26, 188
"d:\panling\yuehua-plugin\src\main\java\com\xiaoxiaoowo\yuehua\entity\npc\dz\MIAOFAGE.java", "Java", 0, 0, 40, 0, 4, 11, 55
"d:\panling\yuehua-plugin\src\main\java\com\xiaoxiaoowo\yuehua\entity\npc\dz\MINGZHUTANG.java", "Java", 0, 0, 114, 0, 4, 22, 140
"d:\panling\yuehua-plugin\src\main\java\com\xiaoxiaoowo\yuehua\entity\npc\dz\TIEJIANGPU.java", "Java", 0, 0, 84, 0, 4, 17, 105
"d:\panling\yuehua-plugin\src\main\java\com\xiaoxiaoowo\yuehua\entity\npc\dz\XUESHIPIN.java", "Java", 0, 0, 129, 0, 4, 25, 158
"d:\panling\yuehua-plugin\src\main\java\com\xiaoxiaoowo\yuehua\entity\npc\dz\YIBAOLOU.java", "Java", 0, 0, 40, 0, 4, 11, 55
"d:\panling\yuehua-plugin\src\main\java\com\xiaoxiaoowo\yuehua\entity\npc\dz\Yiqi.java", "Java", 0, 0, 158, 0, 4, 26, 188
"d:\panling\yuehua-plugin\src\main\java\com\xiaoxiaoowo\yuehua\entity\npc\dz\Ys1.java", "Java", 0, 0, 121, 0, 4, 24, 149
"d:\panling\yuehua-plugin\src\main\java\com\xiaoxiaoowo\yuehua\entity\npc\dz\Ys2.java", "Java", 0, 0, 121, 0, 4, 24, 149
"d:\panling\yuehua-plugin\src\main\java\com\xiaoxiaoowo\yuehua\entity\npc\dz\Ys3.java", "Java", 0, 0, 121, 0, 4, 24, 149
"d:\panling\yuehua-plugin\src\main\java\com\xiaoxiaoowo\yuehua\entity\npc\dz\ZhanWeapon.java", "Java", 0, 0, 158, 0, 4, 26, 188
"d:\panling\yuehua-plugin\src\main\java\com\xiaoxiaoowo\yuehua\entity\npc\east\EastIngerBue.java", "Java", 0, 0, 79, 0, 4, 26, 109
"d:\panling\yuehua-plugin\src\main\java\com\xiaoxiaoowo\yuehua\entity\npc\east\EastQianZhuang.java", "Java", 0, 0, 86, 0, 4, 17, 107
"d:\panling\yuehua-plugin\src\main\java\com\xiaoxiaoowo\yuehua\entity\npc\east\LaoLieHu.java", "Java", 0, 0, 49, 0, 4, 11, 64
"d:\panling\yuehua-plugin\src\main\java\com\xiaoxiaoowo\yuehua\entity\npc\east\SHANSHENMIAO.java", "Java", 0, 0, 102, 0, 4, 22, 128
"d:\panling\yuehua-plugin\src\main\java\com\xiaoxiaoowo\yuehua\entity\npc\east\SHENMUYAOJIN.java", "Java", 0, 0, 105, 0, 4, 20, 129
"d:\panling\yuehua-plugin\src\main\java\com\xiaoxiaoowo\yuehua\entity\npc\food\HAIXIANFAN.java", "Java", 0, 0, 89, 0, 4, 23, 116
"d:\panling\yuehua-plugin\src\main\java\com\xiaoxiaoowo\yuehua\entity\npc\food\HUNCAIFAN.java", "Java", 0, 0, 89, 0, 4, 23, 116
"d:\panling\yuehua-plugin\src\main\java\com\xiaoxiaoowo\yuehua\entity\npc\food\MEISHIJIA.java", "Java", 0, 0, 38, 0, 4, 15, 57
"d:\panling\yuehua-plugin\src\main\java\com\xiaoxiaoowo\yuehua\entity\npc\food\SHUIGUOFAN.java", "Java", 0, 0, 116, 0, 4, 25, 145
"d:\panling\yuehua-plugin\src\main\java\com\xiaoxiaoowo\yuehua\entity\npc\food\SUSHIFAN.java", "Java", 0, 0, 80, 0, 4, 23, 107
"d:\panling\yuehua-plugin\src\main\java\com\xiaoxiaoowo\yuehua\entity\npc\fulin\FuLingTaiYi.java", "Java", 0, 0, 41, 0, 4, 11, 56
"d:\panling\yuehua-plugin\src\main\java\com\xiaoxiaoowo\yuehua\entity\npc\fulin\KEHUASHI1.java", "Java", 0, 0, 126, 0, 4, 12, 142
"d:\panling\yuehua-plugin\src\main\java\com\xiaoxiaoowo\yuehua\entity\npc\fulin\KEHUASHI2.java", "Java", 0, 0, 126, 0, 4, 12, 142
"d:\panling\yuehua-plugin\src\main\java\com\xiaoxiaoowo\yuehua\entity\npc\fulin\KEHUASHI3.java", "Java", 0, 0, 126, 0, 4, 12, 142
"d:\panling\yuehua-plugin\src\main\java\com\xiaoxiaoowo\yuehua\entity\npc\middle\BUMINSHI.java", "Java", 0, 0, 125, 0, 4, 28, 157
"d:\panling\yuehua-plugin\src\main\java\com\xiaoxiaoowo\yuehua\entity\npc\middle\CAOYAOSHOUCANGJIA.java", "Java", 0, 0, 61, 0, 4, 13, 78
"d:\panling\yuehua-plugin\src\main\java\com\xiaoxiaoowo\yuehua\entity\npc\middle\IngredientBuy.java", "Java", 0, 0, 118, 0, 4, 36, 158
"d:\panling\yuehua-plugin\src\main\java\com\xiaoxiaoowo\yuehua\entity\npc\middle\LIANDANFANGXIAOER.java", "Java", 0, 0, 72, 0, 4, 18, 94
"d:\panling\yuehua-plugin\src\main\java\com\xiaoxiaoowo\yuehua\entity\npc\middle\LIANDANZHANGGUI.java", "Java", 0, 0, 41, 0, 4, 12, 57
"d:\panling\yuehua-plugin\src\main\java\com\xiaoxiaoowo\yuehua\entity\npc\middle\MoneLootBuy2.java", "Java", 0, 0, 79, 0, 4, 24, 107
"d:\panling\yuehua-plugin\src\main\java\com\xiaoxiaoowo\yuehua\entity\npc\middle\MoneyLootBuy.java", "Java", 0, 0, 102, 0, 4, 28, 134
"d:\panling\yuehua-plugin\src\main\java\com\xiaoxiaoowo\yuehua\entity\npc\middle\MoneyLootBuy3.java", "Java", 0, 0, 48, 0, 4, 21, 73
"d:\panling\yuehua-plugin\src\main\java\com\xiaoxiaoowo\yuehua\entity\npc\middle\QianZhuang.java", "Java", 0, 0, 86, 0, 4, 17, 107
"d:\panling\yuehua-plugin\src\main\java\com\xiaoxiaoowo\yuehua\entity\npc\middle\YuanSuHuiShou.java", "Java", 0, 0, 75, 0, 4, 23, 102
"d:\panling\yuehua-plugin\src\main\java\com\xiaoxiaoowo\yuehua\entity\npc\middle\YuanSuZhiHuanYuan.java", "Java", 0, 0, 113, 0, 4, 25, 142
"d:\panling\yuehua-plugin\src\main\java\com\xiaoxiaoowo\yuehua\entity\npc\middle\ZAHUO.java", "Java", 0, 0, 99, 0, 4, 21, 124
"d:\panling\yuehua-plugin\src\main\java\com\xiaoxiaoowo\yuehua\entity\npc\middle\ZHIBUFANG.java", "Java", 0, 0, 80, 0, 4, 20, 104
"d:\panling\yuehua-plugin\src\main\java\com\xiaoxiaoowo\yuehua\entity\npc\middle\ZHINV.java", "Java", 0, 0, 106, 0, 4, 21, 131
"d:\panling\yuehua-plugin\src\main\java\com\xiaoxiaoowo\yuehua\entity\npc\qiansigu\DAN.java", "Java", 0, 0, 73, 0, 4, 16, 93
"d:\panling\yuehua-plugin\src\main\java\com\xiaoxiaoowo\yuehua\entity\npc\qiansigu\ZHANGGUI.java", "Java", 0, 0, 72, 0, 4, 15, 91
"d:\panling\yuehua-plugin\src\main\java\com\xiaoxiaoowo\yuehua\entity\npc\tea\CHUYIYE.java", "Java", 0, 0, 42, 0, 4, 11, 57
"d:\panling\yuehua-plugin\src\main\java\com\xiaoxiaoowo\yuehua\entity\npc\tea\TINGZHI.java", "Java", 0, 0, 42, 0, 4, 11, 57
"d:\panling\yuehua-plugin\src\main\java\com\xiaoxiaoowo\yuehua\entity\npc\tea\XIAOER.java", "Java", 0, 0, 57, 0, 4, 19, 80
"d:\panling\yuehua-plugin\src\main\java\com\xiaoxiaoowo\yuehua\entity\npc\yushi\Bingshuangshi.java", "Java", 0, 0, 116, 0, 4, 27, 147
"d:\panling\yuehua-plugin\src\main\java\com\xiaoxiaoowo\yuehua\entity\npc\yushi\Cuilvshi.java", "Java", 0, 0, 116, 0, 4, 27, 147
"d:\panling\yuehua-plugin\src\main\java\com\xiaoxiaoowo\yuehua\entity\npc\yushi\Dianlanshi.java", "Java", 0, 0, 116, 0, 4, 27, 147
"d:\panling\yuehua-plugin\src\main\java\com\xiaoxiaoowo\yuehua\entity\npc\yushi\Hongyueshi.java", "Java", 0, 0, 116, 0, 4, 27, 147
"d:\panling\yuehua-plugin\src\main\java\com\xiaoxiaoowo\yuehua\entity\npc\yushi\Houtushi.java", "Java", 0, 0, 116, 0, 4, 27, 147
"d:\panling\yuehua-plugin\src\main\java\com\xiaoxiaoowo\yuehua\entity\npc\yushi\Jinhuangshi.java", "Java", 0, 0, 116, 0, 4, 27, 147
"d:\panling\yuehua-plugin\src\main\java\com\xiaoxiaoowo\yuehua\entity\npc\yushi\Miyinshi.java", "Java", 0, 0, 116, 0, 4, 27, 147
"d:\panling\yuehua-plugin\src\main\java\com\xiaoxiaoowo\yuehua\entity\npc\yushi\Suiyanshi.java", "Java", 0, 0, 116, 0, 4, 27, 147
"d:\panling\yuehua-plugin\src\main\java\com\xiaoxiaoowo\yuehua\entity\npc\yushi\Tulushi.java", "Java", 0, 0, 116, 0, 4, 27, 147
"d:\panling\yuehua-plugin\src\main\java\com\xiaoxiaoowo\yuehua\entity\npc\yushi\Xueseshi.java", "Java", 0, 0, 116, 0, 4, 27, 147
"d:\panling\yuehua-plugin\src\main\java\com\xiaoxiaoowo\yuehua\entity\npc\yushi\Yanyangshi.java", "Java", 0, 0, 116, 0, 4, 27, 147
"d:\panling\yuehua-plugin\src\main\java\com\xiaoxiaoowo\yuehua\entity\npc\yushi\Yaochijinmu.java", "Java", 0, 0, 41, 0, 4, 19, 64
"d:\panling\yuehua-plugin\src\main\java\com\xiaoxiaoowo\yuehua\entity\npc\yushi\Yulushi.java", "Java", 0, 0, 116, 0, 4, 27, 147
"d:\panling\yuehua-plugin\src\main\java\com\xiaoxiaoowo\yuehua\entity\npc\yushi\Zijinshi.java", "Java", 0, 0, 116, 0, 4, 27, 147
"d:\panling\yuehua-plugin\src\main\java\com\xiaoxiaoowo\yuehua\entity\other\Pig.java", "Java", 0, 0, 18, 0, 5, 4, 27
"d:\panling\yuehua-plugin\src\main\java\com\xiaoxiaoowo\yuehua\entity\pet\other\FeiXianJian.java", "Java", 0, 0, 24, 0, 5, 7, 36
"d:\panling\yuehua-plugin\src\main\java\com\xiaoxiaoowo\yuehua\event\Inventory\Click.java", "Java", 0, 0, 4067, 0, 49, 577, 4693
"d:\panling\yuehua-plugin\src\main\java\com\xiaoxiaoowo\yuehua\event\Inventory\Close.java", "Java", 0, 0, 158, 0, 0, 17, 175
"d:\panling\yuehua-plugin\src\main\java\com\xiaoxiaoowo\yuehua\event\Inventory\Open.java", "Java", 0, 0, 18, 0, 0, 4, 22
"d:\panling\yuehua-plugin\src\main\java\com\xiaoxiaoowo\yuehua\event\Projectile\Hit.java", "Java", 0, 0, 99, 0, 5, 9, 113
"d:\panling\yuehua-plugin\src\main\java\com\xiaoxiaoowo\yuehua\event\Projectile\Launch.java", "Java", 0, 0, 25, 0, 0, 6, 31
"d:\panling\yuehua-plugin\src\main\java\com\xiaoxiaoowo\yuehua\event\Spawner\Spawn.java", "Java", 0, 0, 17, 0, 3, 8, 28
"d:\panling\yuehua-plugin\src\main\java\com\xiaoxiaoowo\yuehua\event\block\CauldronLevelChange.java", "Java", 0, 0, 21, 0, 0, 4, 25
"d:\panling\yuehua-plugin\src\main\java\com\xiaoxiaoowo\yuehua\event\block\Ingite.java", "Java", 0, 0, 11, 0, 0, 4, 15
"d:\panling\yuehua-plugin\src\main\java\com\xiaoxiaoowo\yuehua\event\entity\AddToWorld.java", "Java", 0, 0, 138, 0, 0, 32, 170
"d:\panling\yuehua-plugin\src\main\java\com\xiaoxiaoowo\yuehua\event\entity\Breed.java", "Java", 0, 0, 10, 0, 0, 4, 14
"d:\panling\yuehua-plugin\src\main\java\com\xiaoxiaoowo\yuehua\event\entity\Combust.java", "Java", 0, 0, 17, 0, 0, 4, 21
"d:\panling\yuehua-plugin\src\main\java\com\xiaoxiaoowo\yuehua\event\entity\Damage.java", "Java", 0, 0, 77, 0, 1, 31, 109
"d:\panling\yuehua-plugin\src\main\java\com\xiaoxiaoowo\yuehua\event\entity\DamageByEntity.java", "Java", 0, 0, 742, 0, 32, 238, 1012
"d:\panling\yuehua-plugin\src\main\java\com\xiaoxiaoowo\yuehua\event\entity\Death.java", "Java", 0, 0, 215, 0, 2, 36, 253
"d:\panling\yuehua-plugin\src\main\java\com\xiaoxiaoowo\yuehua\event\entity\LoadCrossBow.java", "Java", 0, 0, 35, 0, 1, 9, 45
"d:\panling\yuehua-plugin\src\main\java\com\xiaoxiaoowo\yuehua\event\entity\PotionSpLash.java", "Java", 0, 0, 29, 0, 0, 7, 36
"d:\panling\yuehua-plugin\src\main\java\com\xiaoxiaoowo\yuehua\event\entity\RegainHealth.java", "Java", 0, 0, 33, 0, 0, 4, 37
"d:\panling\yuehua-plugin\src\main\java\com\xiaoxiaoowo\yuehua\event\entity\RemoveFromWorld.java", "Java", 0, 0, 34, 0, 0, 7, 41
"d:\panling\yuehua-plugin\src\main\java\com\xiaoxiaoowo\yuehua\event\entity\ShootBow.java", "Java", 0, 0, 98, 0, 16, 34, 148
"d:\panling\yuehua-plugin\src\main\java\com\xiaoxiaoowo\yuehua\event\entity\SlimeSpilt.java", "Java", 0, 0, 10, 0, 0, 3, 13
"d:\panling\yuehua-plugin\src\main\java\com\xiaoxiaoowo\yuehua\event\entity\Transform.java", "Java", 0, 0, 10, 0, 0, 4, 14
"d:\panling\yuehua-plugin\src\main\java\com\xiaoxiaoowo\yuehua\event\player\ConsumeItem.java", "Java", 0, 0, 79, 0, 4, 18, 101
"d:\panling\yuehua-plugin\src\main\java\com\xiaoxiaoowo\yuehua\event\player\Death.java", "Java", 0, 0, 33, 0, 17, 12, 62
"d:\panling\yuehua-plugin\src\main\java\com\xiaoxiaoowo\yuehua\event\player\DropItem.java", "Java", 0, 0, 17, 0, 0, 4, 21
"d:\panling\yuehua-plugin\src\main\java\com\xiaoxiaoowo\yuehua\event\player\FlowerPotManipulate.java", "Java", 0, 0, 16, 0, 0, 4, 20
"d:\panling\yuehua-plugin\src\main\java\com\xiaoxiaoowo\yuehua\event\player\Interact.java", "Java", 0, 0, 1144, 0, 27, 175, 1346
"d:\panling\yuehua-plugin\src\main\java\com\xiaoxiaoowo\yuehua\event\player\InventorySlotChange.java", "Java", 0, 0, 686, 0, 112, 54, 852
"d:\panling\yuehua-plugin\src\main\java\com\xiaoxiaoowo\yuehua\event\player\Join.java", "Java", 0, 0, 349, 0, 13, 68, 430
"d:\panling\yuehua-plugin\src\main\java\com\xiaoxiaoowo\yuehua\event\player\LevelChange.java", "Java", 0, 0, 206, 0, 5, 28, 239
"d:\panling\yuehua-plugin\src\main\java\com\xiaoxiaoowo\yuehua\event\player\Login.java", "Java", 0, 0, 23, 0, 0, 7, 30
"d:\panling\yuehua-plugin\src\main\java\com\xiaoxiaoowo\yuehua\event\player\Quit.java", "Java", 0, 0, 116, 0, 1, 11, 128
"d:\panling\yuehua-plugin\src\main\java\com\xiaoxiaoowo\yuehua\event\player\Swap.java", "Java", 0, 0, 13, 0, 0, 3, 16
"d:\panling\yuehua-plugin\src\main\java\com\xiaoxiaoowo\yuehua\event\player\Teleport.java", "Java", 0, 0, 19, 0, 0, 3, 22
"d:\panling\yuehua-plugin\src\main\java\com\xiaoxiaoowo\yuehua\guis\Advancenment.java", "Java", 0, 0, 3, 0, 0, 2, 5
"d:\panling\yuehua-plugin\src\main\java\com\xiaoxiaoowo\yuehua\guis\DuanZao.java", "Java", 0, 0, 363, 0, 0, 70, 433
"d:\panling\yuehua-plugin\src\main\java\com\xiaoxiaoowo\yuehua\guis\Recipe.java", "Java", 0, 0, 280, 0, 2, 85, 367
"d:\panling\yuehua-plugin\src\main\java\com\xiaoxiaoowo\yuehua\guis\Task.java", "Java", 0, 0, 148, 0, 1, 21, 170
"d:\panling\yuehua-plugin\src\main\java\com\xiaoxiaoowo\yuehua\guis\Yh.java", "Java", 0, 0, 899, 0, 10, 98, 1007
"d:\panling\yuehua-plugin\src\main\java\com\xiaoxiaoowo\yuehua\guis\bank\JianDai.java", "Java", 0, 0, 113, 0, 0, 17, 130
"d:\panling\yuehua-plugin\src\main\java\com\xiaoxiaoowo\yuehua\guis\bank\MoneyBank.java", "Java", 0, 0, 175, 0, 3, 32, 210
"d:\panling\yuehua-plugin\src\main\java\com\xiaoxiaoowo\yuehua\guis\bank\YuanSuBank.java", "Java", 0, 0, 337, 0, 4, 70, 411
"d:\panling\yuehua-plugin\src\main\java\com\xiaoxiaoowo\yuehua\guis\op\OpGui.java", "Java", 0, 0, 16, 0, 0, 7, 23
"d:\panling\yuehua-plugin\src\main\java\com\xiaoxiaoowo\yuehua\guis\op\OpTp.java", "Java", 0, 0, 52, 0, 0, 10, 62
"d:\panling\yuehua-plugin\src\main\java\com\xiaoxiaoowo\yuehua\items\Book.java", "Java", 0, 0, 379, 0, 0, 49, 428
"d:\panling\yuehua-plugin\src\main\java\com\xiaoxiaoowo\yuehua\items\PINZHENG.java", "Java", 0, 0, 738, 0, 10, 70, 818
"d:\panling\yuehua-plugin\src\main\java\com\xiaoxiaoowo\yuehua\items\Skill.java", "Java", 0, 0, 13, 0, 0, 4, 17
"d:\panling\yuehua-plugin\src\main\java\com\xiaoxiaoowo\yuehua\items\dz\Core.java", "Java", 0, 0, 3685, 0, 61, 703, 4449
"d:\panling\yuehua-plugin\src\main\java\com\xiaoxiaoowo\yuehua\items\dz\FuLing.java", "Java", 0, 0, 862, 0, 13, 90, 965
"d:\panling\yuehua-plugin\src\main\java\com\xiaoxiaoowo\yuehua\items\dz\Ingredient.java", "Java", 0, 0, 885, 0, 30, 97, 1012
"d:\panling\yuehua-plugin\src\main\java\com\xiaoxiaoowo\yuehua\items\dz\TehuaShui.java", "Java", 0, 0, 316, 0, 0, 82, 398
"d:\panling\yuehua-plugin\src\main\java\com\xiaoxiaoowo\yuehua\items\dz\YuShi.java", "Java", 0, 0, 1577, 0, 13, 170, 1760
"d:\panling\yuehua-plugin\src\main\java\com\xiaoxiaoowo\yuehua\items\dz\YuanSu.java", "Java", 0, 0, 223, 0, 4, 38, 265
"d:\panling\yuehua-plugin\src\main\java\com\xiaoxiaoowo\yuehua\items\liandan\Dan.java", "Java", 0, 0, 121, 0, 11, 38, 170
"d:\panling\yuehua-plugin\src\main\java\com\xiaoxiaoowo\yuehua\items\liandan\Herb.java", "Java", 0, 0, 196, 0, 4, 24, 224
"d:\panling\yuehua-plugin\src\main\java\com\xiaoxiaoowo\yuehua\items\monsterzhuangbei\Boot.java", "Java", 0, 0, 177, 0, 0, 30, 207
"d:\panling\yuehua-plugin\src\main\java\com\xiaoxiaoowo\yuehua\items\monsterzhuangbei\Bow.java", "Java", 0, 0, 71, 0, 0, 19, 90
"d:\panling\yuehua-plugin\src\main\java\com\xiaoxiaoowo\yuehua\items\monsterzhuangbei\Chest.java", "Java", 0, 0, 177, 0, 0, 31, 208
"d:\panling\yuehua-plugin\src\main\java\com\xiaoxiaoowo\yuehua\items\monsterzhuangbei\Helmet.java", "Java", 0, 0, 109, 0, 0, 27, 136
"d:\panling\yuehua-plugin\src\main\java\com\xiaoxiaoowo\yuehua\items\monsterzhuangbei\Leg.java", "Java", 0, 0, 93, 0, 0, 29, 122
"d:\panling\yuehua-plugin\src\main\java\com\xiaoxiaoowo\yuehua\items\monsterzhuangbei\Weapon.java", "Java", 0, 0, 469, 0, 23, 144, 636
"d:\panling\yuehua-plugin\src\main\java\com\xiaoxiaoowo\yuehua\items\other\Collection.java", "Java", 0, 0, 157, 0, 0, 31, 188
"d:\panling\yuehua-plugin\src\main\java\com\xiaoxiaoowo\yuehua\items\other\Feather.java", "Java", 0, 0, 203, 0, 0, 34, 237
"d:\panling\yuehua-plugin\src\main\java\com\xiaoxiaoowo\yuehua\items\other\Food.java", "Java", 0, 0, 808, 0, 8, 83, 899
"d:\panling\yuehua-plugin\src\main\java\com\xiaoxiaoowo\yuehua\items\other\FuBen.java", "Java", 0, 0, 140, 0, 2, 17, 159
"d:\panling\yuehua-plugin\src\main\java\com\xiaoxiaoowo\yuehua\items\other\Money.java", "Java", 0, 0, 94, 0, 0, 22, 116
"d:\panling\yuehua-plugin\src\main\java\com\xiaoxiaoowo\yuehua\items\other\MoneyLoot.java", "Java", 0, 0, 202, 0, 6, 55, 263
"d:\panling\yuehua-plugin\src\main\java\com\xiaoxiaoowo\yuehua\items\other\Other.java", "Java", 0, 0, 64, 0, 0, 18, 82
"d:\panling\yuehua-plugin\src\main\java\com\xiaoxiaoowo\yuehua\items\other\RaceProvince.java", "Java", 0, 0, 85, 0, 0, 25, 110
"d:\panling\yuehua-plugin\src\main\java\com\xiaoxiaoowo\yuehua\items\other\XP.java", "Java", 0, 0, 105, 0, 1, 21, 127
"d:\panling\yuehua-plugin\src\main\java\com\xiaoxiaoowo\yuehua\items\zhuangbei\ArmorChest.java", "Java", 0, 0, 1011, 0, 4, 31, 1046
"d:\panling\yuehua-plugin\src\main\java\com\xiaoxiaoowo\yuehua\items\zhuangbei\ArmorFeet.java", "Java", 0, 0, 990, 0, 4, 31, 1025
"d:\panling\yuehua-plugin\src\main\java\com\xiaoxiaoowo\yuehua\items\zhuangbei\ArmorHead.java", "Java", 0, 0, 999, 0, 4, 61, 1064
"d:\panling\yuehua-plugin\src\main\java\com\xiaoxiaoowo\yuehua\items\zhuangbei\ArmorLeg.java", "Java", 0, 0, 999, 0, 4, 36, 1039
"d:\panling\yuehua-plugin\src\main\java\com\xiaoxiaoowo\yuehua\items\zhuangbei\BiWeapon.java", "Java", 0, 0, 711, 0, 3, 58, 772
"d:\panling\yuehua-plugin\src\main\java\com\xiaoxiaoowo\yuehua\items\zhuangbei\Fabao.java", "Java", 0, 0, 1361, 0, 12, 106, 1479
"d:\panling\yuehua-plugin\src\main\java\com\xiaoxiaoowo\yuehua\items\zhuangbei\Shipin.java", "Java", 0, 0, 2202, 0, 0, 181, 2383
"d:\panling\yuehua-plugin\src\main\java\com\xiaoxiaoowo\yuehua\items\zhuangbei\Weapon.java", "Java", 0, 0, 1557, 0, 10, 76, 1643
"d:\panling\yuehua-plugin\src\main\java\com\xiaoxiaoowo\yuehua\items\zhuangbei\YiQi.java", "Java", 0, 0, 624, 0, 3, 51, 678
"d:\panling\yuehua-plugin\src\main\java\com\xiaoxiaoowo\yuehua\jineng\DoJiNeng.java", "Java", 0, 0, 173, 0, 0, 25, 198
"d:\panling\yuehua-plugin\src\main\java\com\xiaoxiaoowo\yuehua\jineng\dan\zhenfa\Huo.java", "Java", 0, 0, 29, 0, 0, 10, 39
"d:\panling\yuehua-plugin\src\main\java\com\xiaoxiaoowo\yuehua\jineng\dan\zhenfa\Jin.java", "Java", 0, 0, 46, 0, 0, 18, 64
"d:\panling\yuehua-plugin\src\main\java\com\xiaoxiaoowo\yuehua\jineng\dan\zhenfa\Mu.java", "Java", 0, 0, 24, 0, 0, 10, 34
"d:\panling\yuehua-plugin\src\main\java\com\xiaoxiaoowo\yuehua\jineng\dan\zhenfa\Shui.java", "Java", 0, 0, 28, 0, 0, 10, 38
"d:\panling\yuehua-plugin\src\main\java\com\xiaoxiaoowo\yuehua\jineng\dan\zhenfa\Tu.java", "Java", 0, 0, 22, 0, 0, 9, 31
"d:\panling\yuehua-plugin\src\main\java\com\xiaoxiaoowo\yuehua\jineng\gong\weapon\juji\BeiDouMieShenGong.java", "Java", 0, 0, 19, 0, 0, 5, 24
"d:\panling\yuehua-plugin\src\main\java\com\xiaoxiaoowo\yuehua\jineng\gong\weapon\juji\QinTongGong.java", "Java", 0, 0, 19, 0, 0, 4, 23
"d:\panling\yuehua-plugin\src\main\java\com\xiaoxiaoowo\yuehua\jineng\gong\weapon\juji\TengMuGong.java", "Java", 0, 0, 19, 0, 0, 4, 23
"d:\panling\yuehua-plugin\src\main\java\com\xiaoxiaoowo\yuehua\jineng\gong\weapon\juji\YanTieGong.java", "Java", 0, 0, 19, 0, 0, 4, 23
"d:\panling\yuehua-plugin\src\main\java\com\xiaoxiaoowo\yuehua\jineng\gong\weapon\juji\ZhongChuiGong.java", "Java", 0, 0, 19, 0, 0, 4, 23
"d:\panling\yuehua-plugin\src\main\java\com\xiaoxiaoowo\yuehua\jineng\gong\weapon\lingjian\FuRongGong.java", "Java", 0, 0, 25, 0, 0, 7, 32
"d:\panling\yuehua-plugin\src\main\java\com\xiaoxiaoowo\yuehua\jineng\gong\weapon\lingjian\HongLuanGong.java", "Java", 0, 0, 26, 0, 0, 5, 31
"d:\panling\yuehua-plugin\src\main\java\com\xiaoxiaoowo\yuehua\jineng\gong\weapon\lingjian\SheTianZhuiYueGong.java", "Java", 0, 0, 25, 0, 0, 5, 30
"d:\panling\yuehua-plugin\src\main\java\com\xiaoxiaoowo\yuehua\jineng\gong\weapon\lingjian\TianQiongGong.java", "Java", 0, 0, 25, 0, 0, 4, 29
"d:\panling\yuehua-plugin\src\main\java\com\xiaoxiaoowo\yuehua\jineng\gong\weapon\youxia\HeiTieNu.java", "Java", 0, 0, 24, 0, 0, 5, 29
"d:\panling\yuehua-plugin\src\main\java\com\xiaoxiaoowo\yuehua\jineng\gong\weapon\youxia\HongLinNu.java", "Java", 0, 0, 24, 0, 0, 5, 29
"d:\panling\yuehua-plugin\src\main\java\com\xiaoxiaoowo\yuehua\jineng\gong\weapon\youxia\JiaoLongNu.java", "Java", 0, 0, 48, 0, 0, 7, 55
"d:\panling\yuehua-plugin\src\main\java\com\xiaoxiaoowo\yuehua\jineng\gong\weapon\youxia\RiYueLiuXinNu.java", "Java", 0, 0, 16, 0, 0, 5, 21
"d:\panling\yuehua-plugin\src\main\java\com\xiaoxiaoowo\yuehua\jineng\zhan\weapon\jinzhong\ChiTongJian.java", "Java", 0, 0, 37, 0, 0, 7, 44
"d:\panling\yuehua-plugin\src\main\java\com\xiaoxiaoowo\yuehua\jineng\zhan\weapon\jinzhong\KunLunFeiXianJian.java", "Java", 0, 0, 59, 0, 0, 12, 71
"d:\panling\yuehua-plugin\src\main\java\com\xiaoxiaoowo\yuehua\jineng\zhan\weapon\jinzhong\QinTongJian.java", "Java", 0, 0, 28, 0, 0, 6, 34
"d:\panling\yuehua-plugin\src\main\java\com\xiaoxiaoowo\yuehua\jineng\zhan\weapon\jinzhong\TaiJiJian.java", "Java", 0, 0, 42, 0, 1, 7, 50
"d:\panling\yuehua-plugin\src\main\java\com\xiaoxiaoowo\yuehua\jineng\zhan\weapon\pojun\JinGuaChui.java", "Java", 0, 0, 19, 0, 0, 4, 23
"d:\panling\yuehua-plugin\src\main\java\com\xiaoxiaoowo\yuehua\jineng\zhan\weapon\pojun\KaiShanDao.java", "Java", 0, 0, 19, 0, 0, 4, 23
"d:\panling\yuehua-plugin\src\main\java\com\xiaoxiaoowo\yuehua\jineng\zhan\weapon\pojun\PoKongFu.java", "Java", 0, 0, 19, 0, 0, 4, 23
"d:\panling\yuehua-plugin\src\main\java\com\xiaoxiaoowo\yuehua\jineng\zhan\weapon\pojun\SanBaoYuRuYi.java", "Java", 0, 0, 19, 0, 0, 4, 23
"d:\panling\yuehua-plugin\src\main\java\com\xiaoxiaoowo\yuehua\jineng\zhan\weapon\pojun\TaoMuJian.java", "Java", 0, 0, 29, 0, 0, 6, 35
"d:\panling\yuehua-plugin\src\main\java\com\xiaoxiaoowo\yuehua\jineng\zhan\weapon\tanyun\HongYinQiang.java", "Java", 0, 0, 38, 0, 0, 12, 50
"d:\panling\yuehua-plugin\src\main\java\com\xiaoxiaoowo\yuehua\jineng\zhan\weapon\tanyun\HuTouZhanJinQiang.java", "Java", 0, 0, 51, 0, 0, 15, 66
"d:\panling\yuehua-plugin\src\main\java\com\xiaoxiaoowo\yuehua\jineng\zhan\weapon\tanyun\YinYueQiang.java", "Java", 0, 0, 28, 0, 0, 9, 37
"d:\panling\yuehua-plugin\src\main\java\com\xiaoxiaoowo\yuehua\jineng\zhan\weapon\tanyun\YouLongQiang.java", "Java", 0, 0, 51, 0, 0, 10, 61
"d:\panling\yuehua-plugin\src\main\java\com\xiaoxiaoowo\yuehua\shilian\huancheng\HuanCheng.java", "Java", 0, 0, 100, 0, 1, 22, 123
"d:\panling\yuehua-plugin\src\main\java\com\xiaoxiaoowo\yuehua\system\Act.java", "Java", 0, 0, 429, 0, 1, 86, 516
"d:\panling\yuehua-plugin\src\main\java\com\xiaoxiaoowo\yuehua\system\Buff.java", "Java", 0, 0, 600, 0, 0, 66, 666
"d:\panling\yuehua-plugin\src\main\java\com\xiaoxiaoowo\yuehua\system\Cure.java", "Java", 0, 0, 102, 0, 5, 18, 125
"d:\panling\yuehua-plugin\src\main\java\com\xiaoxiaoowo\yuehua\system\Damage.java", "Java", 0, 0, 396, 0, 28, 137, 561
"d:\panling\yuehua-plugin\src\main\java\com\xiaoxiaoowo\yuehua\system\DataContainer.java", "Java", 0, 0, 249, 0, 24, 78, 351
"d:\panling\yuehua-plugin\src\main\java\com\xiaoxiaoowo\yuehua\system\Init.java", "Java", 0, 0, 145, 0, 0, 34, 179
"d:\panling\yuehua-plugin\src\main\java\com\xiaoxiaoowo\yuehua\system\Team.java", "Java", 0, 0, 49, 0, 1, 9, 59
"d:\panling\yuehua-plugin\src\main\java\com\xiaoxiaoowo\yuehua\system\act\ActFuling.java", "Java", 0, 0, 837, 0, 0, 106, 943
"d:\panling\yuehua-plugin\src\main\java\com\xiaoxiaoowo\yuehua\system\act\ActYuShi.java", "Java", 0, 0, 1660, 0, 0, 236, 1896
"d:\panling\yuehua-plugin\src\main\java\com\xiaoxiaoowo\yuehua\system\dz\Fabao.java", "Java", 0, 0, 27, 0, 3, 8, 38
"d:\panling\yuehua-plugin\src\main\java\com\xiaoxiaoowo\yuehua\system\dz\Help.java", "Java", 0, 0, 39, 0, 2, 8, 49
"d:\panling\yuehua-plugin\src\main\java\com\xiaoxiaoowo\yuehua\system\dz\LianDan.java", "Java", 0, 0, 29, 0, 6, 7, 42
"d:\panling\yuehua-plugin\src\main\java\com\xiaoxiaoowo\yuehua\system\dz\Shipin.java", "Java", 0, 0, 19, 0, 3, 4, 26
"d:\panling\yuehua-plugin\src\main\java\com\xiaoxiaoowo\yuehua\system\dz\TieJiangPu.java", "Java", 0, 0, 46, 0, 3, 20, 69
"d:\panling\yuehua-plugin\src\main\java\com\xiaoxiaoowo\yuehua\system\dz\Yiqi.java", "Java", 0, 0, 28, 0, 3, 7, 38
"d:\panling\yuehua-plugin\src\main\java\com\xiaoxiaoowo\yuehua\system\handleMonsters\DoMonsterAttack.java", "Java", 0, 0, 58, 0, 0, 15, 73
"d:\panling\yuehua-plugin\src\main\java\com\xiaoxiaoowo\yuehua\system\handleMonsters\DoMonsterAttacked.java", "Java", 0, 0, 41, 0, 0, 12, 53
"d:\panling\yuehua-plugin\src\main\java\com\xiaoxiaoowo\yuehua\system\handleMonsters\DoMonsterDeath.java", "Java", 0, 0, 11, 0, 0, 8, 19
"d:\panling\yuehua-plugin\src\main\java\com\xiaoxiaoowo\yuehua\system\handleMonsters\DoMonsterMoFaAttacked.java", "Java", 0, 0, 20, 0, 0, 4, 24
"d:\panling\yuehua-plugin\src\main\java\com\xiaoxiaoowo\yuehua\system\handleMonsters\DoMonsterShoot.java", "Java", 0, 0, 9, 0, 0, 4, 13
"d:\panling\yuehua-plugin\src\main\java\com\xiaoxiaoowo\yuehua\system\handleMonsters\DoMonsterWuLiAttacked.java", "Java", 0, 0, 72, 0, 0, 15, 87
"d:\panling\yuehua-plugin\src\main\java\com\xiaoxiaoowo\yuehua\system\handleObsevers\DoAttackObserver.java", "Java", 0, 0, 195, 0, 1, 23, 219
"d:\panling\yuehua-plugin\src\main\java\com\xiaoxiaoowo\yuehua\system\handleObsevers\DoAttackedObserver.java", "Java", 0, 0, 249, 0, 0, 53, 302
"d:\panling\yuehua-plugin\src\main\java\com\xiaoxiaoowo\yuehua\system\handleObsevers\DoBaojiObserver.java", "Java", 0, 0, 16, 0, 0, 5, 21
"d:\panling\yuehua-plugin\src\main\java\com\xiaoxiaoowo\yuehua\system\handleObsevers\DoCuredObserver.java", "Java", 0, 0, 14, 0, 0, 5, 19
"d:\panling\yuehua-plugin\src\main\java\com\xiaoxiaoowo\yuehua\system\handleObsevers\DoDeathObserver.java", "Java", 0, 0, 13, 0, 0, 5, 18
"d:\panling\yuehua-plugin\src\main\java\com\xiaoxiaoowo\yuehua\system\handleObsevers\DoHitObserver.java", "Java", 0, 0, 160, 0, 0, 36, 196
"d:\panling\yuehua-plugin\src\main\java\com\xiaoxiaoowo\yuehua\system\handleObsevers\DoHuDunObserver.java", "Java", 0, 0, 14, 0, 0, 4, 18
"d:\panling\yuehua-plugin\src\main\java\com\xiaoxiaoowo\yuehua\system\handleObsevers\DoJiNengObservers.java", "Java", 0, 0, 54, 0, 1, 12, 67
"d:\panling\yuehua-plugin\src\main\java\com\xiaoxiaoowo\yuehua\system\handleObsevers\DoKillMonsterObserver.java", "Java", 0, 0, 67, 0, 0, 22, 89
"d:\panling\yuehua-plugin\src\main\java\com\xiaoxiaoowo\yuehua\system\handleObsevers\DoPlayerProjectileObserver.java", "Java", 0, 0, 456, 0, 3, 73, 532
"d:\panling\yuehua-plugin\src\main\java\com\xiaoxiaoowo\yuehua\system\handleObsevers\DoZhenfaObserver.java", "Java", 0, 0, 53, 0, 1, 14, 68
"d:\panling\yuehua-plugin\src\main\java\com\xiaoxiaoowo\yuehua\system\handlePets\DoPetAttack.java", "Java", 0, 0, 17, 0, 0, 4, 21
"d:\panling\yuehua-plugin\src\main\java\com\xiaoxiaoowo\yuehua\system\handlePets\DoPetAttacked.java", "Java", 0, 0, 12, 0, 0, 4, 16
"d:\panling\yuehua-plugin\src\main\java\com\xiaoxiaoowo\yuehua\system\handlePets\DoPetDeath.java", "Java", 0, 0, 20, 0, 0, 6, 26
"d:\panling\yuehua-plugin\src\main\java\com\xiaoxiaoowo\yuehua\system\handlePets\DoPetShoot.java", "Java", 0, 0, 9, 0, 0, 5, 14
"d:\panling\yuehua-plugin\src\main\java\com\xiaoxiaoowo\yuehua\task\check\DayOfWeek.java", "Java", 0, 0, 29, 0, 0, 6, 35
"d:\panling\yuehua-plugin\src\main\java\com\xiaoxiaoowo\yuehua\task\check\Fulong.java", "Java", 0, 0, 29, 0, 0, 6, 35
"d:\panling\yuehua-plugin\src\main\java\com\xiaoxiaoowo\yuehua\task\check\Month.java", "Java", 0, 0, 29, 0, 0, 6, 35
"d:\panling\yuehua-plugin\src\main\java\com\xiaoxiaoowo\yuehua\task\check\Num.java", "Java", 0, 0, 31, 0, 0, 8, 39
"d:\panling\yuehua-plugin\src\main\java\com\xiaoxiaoowo\yuehua\task\check\Xiaoxiao.java", "Java", 0, 0, 29, 0, 0, 6, 35
"d:\panling\yuehua-plugin\src\main\java\com\xiaoxiaoowo\yuehua\task\check\Year.java", "Java", 0, 0, 29, 0, 0, 6, 35
"d:\panling\yuehua-plugin\src\main\java\com\xiaoxiaoowo\yuehua\task\hujia\Xie1.java", "Java", 0, 0, 37, 0, 0, 8, 45
"d:\panling\yuehua-plugin\src\main\java\com\xiaoxiaoowo\yuehua\task\hujia\Xie2345.java", "Java", 0, 0, 43, 0, 1, 13, 57
"d:\panling\yuehua-plugin\src\main\java\com\xiaoxiaoowo\yuehua\task\hujia\Xiong1.java", "Java", 0, 0, 44, 0, 0, 13, 57
"d:\panling\yuehua-plugin\src\main\java\com\xiaoxiaoowo\yuehua\task\hujia\Xiong2345.java", "Java", 0, 0, 42, 0, 0, 12, 54
"d:\panling\yuehua-plugin\src\main\java\com\xiaoxiaoowo\yuehua\task\other\ContinueLineDamage.java", "Java", 0, 0, 36, 0, 0, 9, 45
"d:\panling\yuehua-plugin\src\main\java\com\xiaoxiaoowo\yuehua\task\other\ContinueRangeDamage.java", "Java", 0, 0, 38, 0, 0, 8, 46
"d:\panling\yuehua-plugin\src\main\java\com\xiaoxiaoowo\yuehua\task\other\ContinuedLoseHp.java", "Java", 0, 0, 40, 0, 0, 13, 53
"d:\panling\yuehua-plugin\src\main\java\com\xiaoxiaoowo\yuehua\task\other\DrawProjectile.java", "Java", 0, 0, 60, 0, 0, 14, 74
"d:\panling\yuehua-plugin\src\main\java\com\xiaoxiaoowo\yuehua\task\other\LandDu.java", "Java", 0, 0, 29, 0, 1, 8, 38
"d:\panling\yuehua-plugin\src\main\java\com\xiaoxiaoowo\yuehua\task\other\ReflectProjectile.java", "Java", 0, 0, 63, 0, 0, 19, 82
"d:\panling\yuehua-plugin\src\main\java\com\xiaoxiaoowo\yuehua\task\other\SaleTask.java", "Java", 0, 0, 112, 0, 1, 17, 130
"d:\panling\yuehua-plugin\src\main\java\com\xiaoxiaoowo\yuehua\task\other\ShuiDu.java", "Java", 0, 0, 28, 0, 1, 8, 37
"d:\panling\yuehua-plugin\src\main\java\com\xiaoxiaoowo\yuehua\task\player\BGM.java", "Java", 0, 0, 18, 0, 0, 6, 24
"d:\panling\yuehua-plugin\src\main\java\com\xiaoxiaoowo\yuehua\task\player\DisplayHp.java", "Java", 0, 0, 101, 0, 0, 25, 126
"d:\panling\yuehua-plugin\src\main\java\com\xiaoxiaoowo\yuehua\task\regainAttribute\RegainAttack.java", "Java", 0, 0, 24, 0, 0, 7, 31
"d:\panling\yuehua-plugin\src\main\java\com\xiaoxiaoowo\yuehua\task\regainAttribute\RegainFakang.java", "Java", 0, 0, 24, 0, 0, 7, 31
"d:\panling\yuehua-plugin\src\main\java\com\xiaoxiaoowo\yuehua\task\regainAttribute\RegainGedang.java", "Java", 0, 0, 24, 0, 0, 6, 30
"d:\panling\yuehua-plugin\src\main\java\com\xiaoxiaoowo\yuehua\task\regainAttribute\RegainHujia.java", "Java", 0, 0, 24, 0, 0, 6, 30
"d:\panling\yuehua-plugin\src\main\java\com\xiaoxiaoowo\yuehua\task\regainAttribute\RegainPofa.java", "Java", 0, 0, 24, 0, 0, 7, 31
"d:\panling\yuehua-plugin\src\main\java\com\xiaoxiaoowo\yuehua\task\regainAttribute\RegainPojia.java", "Java", 0, 0, 24, 0, 0, 8, 32
"d:\panling\yuehua-plugin\src\main\java\com\xiaoxiaoowo\yuehua\task\regainAttribute\RegainRenxing.java", "Java", 0, 0, 24, 0, 0, 6, 30
"d:\panling\yuehua-plugin\src\main\java\com\xiaoxiaoowo\yuehua\task\regainAttribute\RegainShengJi.java", "Java", 0, 0, 24, 0, 0, 7, 31
"d:\panling\yuehua-plugin\src\main\java\com\xiaoxiaoowo\yuehua\task\regainAttribute\XuanYun.java", "Java", 0, 0, 24, 0, 0, 8, 32
"d:\panling\yuehua-plugin\src\main\java\com\xiaoxiaoowo\yuehua\task\weapon\HongYinQiangFire.java", "Java", 0, 0, 41, 0, 0, 12, 53
"d:\panling\yuehua-plugin\src\main\java\com\xiaoxiaoowo\yuehua\task\weapon\SheTian.java", "Java", 0, 0, 23, 0, 1, 6, 30
"d:\panling\yuehua-plugin\src\main\java\com\xiaoxiaoowo\yuehua\task\weapon\YouLong.java", "Java", 0, 0, 32, 0, 0, 8, 40
"d:\panling\yuehua-plugin\src\main\java\com\xiaoxiaoowo\yuehua\task\weapon\YouLongShui.java", "Java", 0, 0, 42, 0, 1, 10, 53
"d:\panling\yuehua-plugin\src\main\java\com\xiaoxiaoowo\yuehua\task\yiqi\LAOZHANSHIDUNPAI.java", "Java", 0, 0, 26, 0, 0, 10, 36
"d:\panling\yuehua-plugin\src\main\java\com\xiaoxiaoowo\yuehua\utils\Check.java", "Java", 0, 0, 50, 0, 0, 13, 63
"d:\panling\yuehua-plugin\src\main\java\com\xiaoxiaoowo\yuehua\utils\ComponentSet.java", "Java", 0, 0, 51, 0, 0, 12, 63
"d:\panling\yuehua-plugin\src\main\java\com\xiaoxiaoowo\yuehua\utils\GetEntity.java", "Java", 0, 0, 1701, 0, 165, 199, 2065
"d:\panling\yuehua-plugin\src\main\java\com\xiaoxiaoowo\yuehua\utils\LocationCheck.java", "Java", 0, 0, 198, 0, 45, 43, 286
"d:\panling\yuehua-plugin\src\main\java\com\xiaoxiaoowo\yuehua\utils\LocationSet.java", "Java", 0, 0, 85, 0, 1, 4, 90
"d:\panling\yuehua-plugin\src\main\java\com\xiaoxiaoowo\yuehua\utils\MoveEntity.java", "Java", 0, 0, 162, 0, 26, 53, 241
"d:\panling\yuehua-plugin\src\main\java\com\xiaoxiaoowo\yuehua\utils\MySocket.java", "Java", 0, 0, 253, 0, 4, 44, 301
"d:\panling\yuehua-plugin\src\main\java\com\xiaoxiaoowo\yuehua\utils\PlaySound.java", "Java", 0, 0, 173, 0, 0, 61, 234
"d:\panling\yuehua-plugin\src\main\java\com\xiaoxiaoowo\yuehua\utils\RandomChest.java", "Java", 0, 0, 137, 0, 0, 16, 153
"d:\panling\yuehua-plugin\src\main\java\com\xiaoxiaoowo\yuehua\utils\SQL.java", "Java", 0, 0, 2894, 0, 79, 465, 3438
"d:\panling\yuehua-plugin\src\main\java\com\xiaoxiaoowo\yuehua\utils\Scheduler.java", "Java", 0, 0, 40, 0, 1, 14, 55
"d:\panling\yuehua-plugin\src\main\java\com\xiaoxiaoowo\yuehua\utils\SendInformation.java", "Java", 0, 0, 76, 0, 0, 26, 102
"d:\panling\yuehua-plugin\src\main\java\com\xiaoxiaoowo\yuehua\utils\Transfer.java", "Java", 0, 0, 64, 0, 0, 48, 112
"d:\panling\yuehua-plugin\src\main\java\com\xiaoxiaoowo\yuehua\utils\ZeroAttributeModifier.java", "Java", 0, 0, 33, 0, 0, 9, 42
"d:\panling\yuehua-plugin\src\main\java\com\xiaoxiaoowo\yuehua\utils\loot\MyLootTable.java", "Java", 0, 0, 38, 0, 0, 13, 51
"d:\panling\yuehua-plugin\src\main\java\com\xiaoxiaoowo\yuehua\utils\loot\NumItem.java", "Java", 0, 0, 10, 0, 0, 4, 14
"d:\panling\yuehua-plugin\src\main\java\com\xiaoxiaoowo\yuehua\utils\loot\ProItem.java", "Java", 0, 0, 10, 0, 0, 4, 14
"d:\panling\yuehua-plugin\src\main\resources\plugin.yml", "YAML", 0, 80, 0, 0, 0, 1, 81
"Total", "-", 317, 80, 68055, 1, 2724, 11530, 82707