"filename", "language", "YAML", "Java", "comment", "blank", "total"
"d:\panling\yuehua-plugin\src\main\java\com\xiaoxiaoowo\yuehua\Yuehua.java", "Java", 0, 304, 38, 68, 410
"d:\panling\yuehua-plugin\src\main\java\com\xiaoxiaoowo\yuehua\attribute\AttributeSet.java", "Java", 0, 1900, 0, 307, 2207
"d:\panling\yuehua-plugin\src\main\java\com\xiaoxiaoowo\yuehua\attribute\attributes\MyAttribute.java", "Java", 0, 8, 0, 6, 14
"d:\panling\yuehua-plugin\src\main\java\com\xiaoxiaoowo\yuehua\attribute\attributes\fangyu\Fakang.java", "Java", 0, 34, 0, 7, 41
"d:\panling\yuehua-plugin\src\main\java\com\xiaoxiaoowo\yuehua\attribute\attributes\fangyu\Gedang.java", "Java", 0, 34, 0, 7, 41
"d:\panling\yuehua-plugin\src\main\java\com\xiaoxiaoowo\yuehua\attribute\attributes\fangyu\Hujia.java", "Java", 0, 34, 0, 7, 41
"d:\panling\yuehua-plugin\src\main\java\com\xiaoxiaoowo\yuehua\attribute\attributes\fangyu\Renxing.java", "Java", 0, 34, 0, 7, 41
"d:\panling\yuehua-plugin\src\main\java\com\xiaoxiaoowo\yuehua\attribute\attributes\fangyu\Shengji.java", "Java", 0, 34, 0, 7, 41
"d:\panling\yuehua-plugin\src\main\java\com\xiaoxiaoowo\yuehua\attribute\attributes\fangyu\ShouHu.java", "Java", 0, 34, 0, 7, 41
"d:\panling\yuehua-plugin\src\main\java\com\xiaoxiaoowo\yuehua\attribute\attributes\jingong\ArrowAdd.java", "Java", 0, 43, 0, 14, 57
"d:\panling\yuehua-plugin\src\main\java\com\xiaoxiaoowo\yuehua\attribute\attributes\jingong\ArrowMul.java", "Java", 0, 43, 0, 14, 57
"d:\panling\yuehua-plugin\src\main\java\com\xiaoxiaoowo\yuehua\attribute\attributes\jingong\AttackAdd.java", "Java", 0, 40, 0, 14, 54
"d:\panling\yuehua-plugin\src\main\java\com\xiaoxiaoowo\yuehua\attribute\attributes\jingong\AttackMul.java", "Java", 0, 40, 0, 13, 53
"d:\panling\yuehua-plugin\src\main\java\com\xiaoxiaoowo\yuehua\attribute\attributes\jingong\BaoJi.java", "Java", 0, 34, 0, 7, 41
"d:\panling\yuehua-plugin\src\main\java\com\xiaoxiaoowo\yuehua\attribute\attributes\jingong\BaojiXiaoguo.java", "Java", 0, 34, 0, 7, 41
"d:\panling\yuehua-plugin\src\main\java\com\xiaoxiaoowo\yuehua\attribute\attributes\jingong\CoolReduce.java", "Java", 0, 34, 0, 7, 41
"d:\panling\yuehua-plugin\src\main\java\com\xiaoxiaoowo\yuehua\attribute\attributes\jingong\CoolReduceUnlimited.java", "Java", 0, 30, 0, 7, 37
"d:\panling\yuehua-plugin\src\main\java\com\xiaoxiaoowo\yuehua\attribute\attributes\jingong\JinGongMul.java", "Java", 0, 87, 0, 31, 118
"d:\panling\yuehua-plugin\src\main\java\com\xiaoxiaoowo\yuehua\attribute\attributes\jingong\JingongAdd.java", "Java", 0, 90, 0, 29, 119
"d:\panling\yuehua-plugin\src\main\java\com\xiaoxiaoowo\yuehua\attribute\attributes\jingong\Pofa.java", "Java", 0, 34, 0, 7, 41
"d:\panling\yuehua-plugin\src\main\java\com\xiaoxiaoowo\yuehua\attribute\attributes\jingong\Pojia.java", "Java", 0, 34, 0, 7, 41
"d:\panling\yuehua-plugin\src\main\java\com\xiaoxiaoowo\yuehua\attribute\attributes\jingong\ZhenfaAdd.java", "Java", 0, 43, 0, 14, 57
"d:\panling\yuehua-plugin\src\main\java\com\xiaoxiaoowo\yuehua\attribute\attributes\jingong\ZhenfaMul.java", "Java", 0, 43, 0, 16, 59
"d:\panling\yuehua-plugin\src\main\java\com\xiaoxiaoowo\yuehua\attribute\attributes\special\ArrowCountMax.java", "Java", 0, 30, 0, 7, 37
"d:\panling\yuehua-plugin\src\main\java\com\xiaoxiaoowo\yuehua\attribute\attributes\special\Danlu.java", "Java", 0, 41, 0, 9, 50
"d:\panling\yuehua-plugin\src\main\java\com\xiaoxiaoowo\yuehua\attribute\attributes\special\IsBow.java", "Java", 0, 25, 0, 5, 30
"d:\panling\yuehua-plugin\src\main\java\com\xiaoxiaoowo\yuehua\attribute\attributes\special\SlotWithId.java", "Java", 0, 117, 0, 8, 125
"d:\panling\yuehua-plugin\src\main\java\com\xiaoxiaoowo\yuehua\attribute\attributes\vanilla\AttackRange.java", "Java", 0, 35, 0, 8, 43
"d:\panling\yuehua-plugin\src\main\java\com\xiaoxiaoowo\yuehua\attribute\attributes\vanilla\AttackSpeed.java", "Java", 0, 35, 0, 7, 42
"d:\panling\yuehua-plugin\src\main\java\com\xiaoxiaoowo\yuehua\attribute\attributes\vanilla\DingLi.java", "Java", 0, 36, 0, 8, 44
"d:\panling\yuehua-plugin\src\main\java\com\xiaoxiaoowo\yuehua\attribute\attributes\vanilla\Hp.java", "Java", 0, 35, 0, 7, 42
"d:\panling\yuehua-plugin\src\main\java\com\xiaoxiaoowo\yuehua\attribute\attributes\vanilla\HpMul.java", "Java", 0, 54, 0, 11, 65
"d:\panling\yuehua-plugin\src\main\java\com\xiaoxiaoowo\yuehua\attribute\attributes\vanilla\Jump.java", "Java", 0, 37, 0, 9, 46
"d:\panling\yuehua-plugin\src\main\java\com\xiaoxiaoowo\yuehua\attribute\attributes\vanilla\Speed.java", "Java", 0, 56, 0, 11, 67
"d:\panling\yuehua-plugin\src\main\java\com\xiaoxiaoowo\yuehua\commands\Test.java", "Java", 0, 1134, 671, 354, 2159
"d:\panling\yuehua-plugin\src\main\java\com\xiaoxiaoowo\yuehua\commands\blockcommand\Advancement.java", "Java", 0, 38, 0, 6, 44
"d:\panling\yuehua-plugin\src\main\java\com\xiaoxiaoowo\yuehua\commands\blockcommand\BlockTp.java", "Java", 0, 106, 0, 18, 124
"d:\panling\yuehua-plugin\src\main\java\com\xiaoxiaoowo\yuehua\commands\blockcommand\IntoGame.java", "Java", 0, 236, 13, 37, 286
"d:\panling\yuehua-plugin\src\main\java\com\xiaoxiaoowo\yuehua\commands\blockcommand\MarkRelife.java", "Java", 0, 64, 0, 8, 72
"d:\panling\yuehua-plugin\src\main\java\com\xiaoxiaoowo\yuehua\commands\blockcommand\Mission.java", "Java", 0, 151, 0, 28, 179
"d:\panling\yuehua-plugin\src\main\java\com\xiaoxiaoowo\yuehua\commands\blockcommand\MyBossSpawn.java", "Java", 0, 77, 0, 13, 90
"d:\panling\yuehua-plugin\src\main\java\com\xiaoxiaoowo\yuehua\commands\blockcommand\MySpawn.java", "Java", 0, 74, 0, 15, 89
"d:\panling\yuehua-plugin\src\main\java\com\xiaoxiaoowo\yuehua\commands\blockcommand\Relife.java", "Java", 0, 123, 1, 19, 143
"d:\panling\yuehua-plugin\src\main\java\com\xiaoxiaoowo\yuehua\commands\blockcommand\RenOu.java", "Java", 0, 56, 0, 7, 63
"d:\panling\yuehua-plugin\src\main\java\com\xiaoxiaoowo\yuehua\commands\blockcommand\RenOu2.java", "Java", 0, 56, 0, 6, 62
"d:\panling\yuehua-plugin\src\main\java\com\xiaoxiaoowo\yuehua\commands\blockcommand\RenOu3.java", "Java", 0, 56, 0, 6, 62
"d:\panling\yuehua-plugin\src\main\java\com\xiaoxiaoowo\yuehua\commands\blockcommand\Select.java", "Java", 0, 168, 1, 19, 188
"d:\panling\yuehua-plugin\src\main\java\com\xiaoxiaoowo\yuehua\commands\blockcommand\StoreRelifeStone.java", "Java", 0, 59, 0, 15, 74
"d:\panling\yuehua-plugin\src\main\java\com\xiaoxiaoowo\yuehua\commands\opcommand\A.java", "Java", 0, 21, 0, 4, 25
"d:\panling\yuehua-plugin\src\main\java\com\xiaoxiaoowo\yuehua\commands\opcommand\Check.java", "Java", 0, 3, 0, 2, 5
"d:\panling\yuehua-plugin\src\main\java\com\xiaoxiaoowo\yuehua\commands\opcommand\Clearup.java", "Java", 0, 63, 0, 9, 72
"d:\panling\yuehua-plugin\src\main\java\com\xiaoxiaoowo\yuehua\commands\opcommand\FixLore.java", "Java", 0, 23, 0, 4, 27
"d:\panling\yuehua-plugin\src\main\java\com\xiaoxiaoowo\yuehua\commands\opcommand\GI.java", "Java", 0, 976, 134, 97, 1207
"d:\panling\yuehua-plugin\src\main\java\com\xiaoxiaoowo\yuehua\commands\opcommand\MySave.java", "Java", 0, 23, 0, 4, 27
"d:\panling\yuehua-plugin\src\main\java\com\xiaoxiaoowo\yuehua\commands\opcommand\MyTp.java", "Java", 0, 98, 0, 6, 104
"d:\panling\yuehua-plugin\src\main\java\com\xiaoxiaoowo\yuehua\commands\opcommand\MyTpTab.java", "Java", 0, 26, 0, 6, 32
"d:\panling\yuehua-plugin\src\main\java\com\xiaoxiaoowo\yuehua\commands\opcommand\PerGet.java", "Java", 0, 30, 30, 9, 69
"d:\panling\yuehua-plugin\src\main\java\com\xiaoxiaoowo\yuehua\commands\opcommand\R.java", "Java", 0, 21, 0, 4, 25
"d:\panling\yuehua-plugin\src\main\java\com\xiaoxiaoowo\yuehua\commands\opcommand\SetSign.java", "Java", 0, 45, 0, 14, 59
"d:\panling\yuehua-plugin\src\main\java\com\xiaoxiaoowo\yuehua\commands\opcommand\Summon.java", "Java", 0, 341, 0, 35, 376
"d:\panling\yuehua-plugin\src\main\java\com\xiaoxiaoowo\yuehua\commands\opcommand\data\DataCountGet.java", "Java", 0, 29, 0, 5, 34
"d:\panling\yuehua-plugin\src\main\java\com\xiaoxiaoowo\yuehua\commands\opcommand\data\DataGet.java", "Java", 0, 38, 0, 5, 43
"d:\panling\yuehua-plugin\src\main\java\com\xiaoxiaoowo\yuehua\commands\opcommand\data\DataSet.java", "Java", 0, 53, 0, 23, 76
"d:\panling\yuehua-plugin\src\main\java\com\xiaoxiaoowo\yuehua\commands\opcommand\data\ItemDataGet.java", "Java", 0, 43, 0, 7, 50
"d:\panling\yuehua-plugin\src\main\java\com\xiaoxiaoowo\yuehua\commands\playercommand\ArrowCMD.java", "Java", 0, 173, 0, 28, 201
"d:\panling\yuehua-plugin\src\main\java\com\xiaoxiaoowo\yuehua\commands\playercommand\Buy.java", "Java", 0, 82, 0, 16, 98
"d:\panling\yuehua-plugin\src\main\java\com\xiaoxiaoowo\yuehua\commands\playercommand\Check.java", "Java", 0, 102, 0, 20, 122
"d:\panling\yuehua-plugin\src\main\java\com\xiaoxiaoowo\yuehua\commands\playercommand\Kill.java", "Java", 0, 14, 0, 3, 17
"d:\panling\yuehua-plugin\src\main\java\com\xiaoxiaoowo\yuehua\commands\playercommand\MoneyCMD.java", "Java", 0, 416, 2, 62, 480
"d:\panling\yuehua-plugin\src\main\java\com\xiaoxiaoowo\yuehua\commands\playercommand\Sale.java", "Java", 0, 98, 0, 25, 123
"d:\panling\yuehua-plugin\src\main\java\com\xiaoxiaoowo\yuehua\commands\playercommand\Sell.java", "Java", 0, 142, 1, 28, 171
"d:\panling\yuehua-plugin\src\main\java\com\xiaoxiaoowo\yuehua\commands\playercommand\Yhteam.java", "Java", 0, 300, 0, 73, 373
"d:\panling\yuehua-plugin\src\main\java\com\xiaoxiaoowo\yuehua\commands\playercommand\YuanSuCMD.java", "Java", 0, 1027, 0, 26, 1053
"d:\panling\yuehua-plugin\src\main\java\com\xiaoxiaoowo\yuehua\commands\playercommand\completer\ArrowCom.java", "Java", 0, 27, 0, 7, 34
"d:\panling\yuehua-plugin\src\main\java\com\xiaoxiaoowo\yuehua\commands\playercommand\completer\BuyCom.java", "Java", 0, 18, 0, 4, 22
"d:\panling\yuehua-plugin\src\main\java\com\xiaoxiaoowo\yuehua\commands\playercommand\completer\Check.java", "Java", 0, 16, 0, 4, 20
"d:\panling\yuehua-plugin\src\main\java\com\xiaoxiaoowo\yuehua\commands\playercommand\completer\MoneyCom.java", "Java", 0, 41, 0, 13, 54
"d:\panling\yuehua-plugin\src\main\java\com\xiaoxiaoowo\yuehua\commands\playercommand\completer\SaleCom.java", "Java", 0, 21, 0, 4, 25
"d:\panling\yuehua-plugin\src\main\java\com\xiaoxiaoowo\yuehua\commands\playercommand\completer\SellCom.java", "Java", 0, 21, 0, 4, 25
"d:\panling\yuehua-plugin\src\main\java\com\xiaoxiaoowo\yuehua\commands\playercommand\completer\Yhteam.java", "Java", 0, 33, 0, 9, 42
"d:\panling\yuehua-plugin\src\main\java\com\xiaoxiaoowo\yuehua\commands\playercommand\completer\YuanSuCom.java", "Java", 0, 35, 0, 8, 43
"d:\panling\yuehua-plugin\src\main\java\com\xiaoxiaoowo\yuehua\data\DanData.java", "Java", 0, 127, 1, 41, 169
"d:\panling\yuehua-plugin\src\main\java\com\xiaoxiaoowo\yuehua\data\Data.java", "Java", 0, 1087, 47, 267, 1401
"d:\panling\yuehua-plugin\src\main\java\com\xiaoxiaoowo\yuehua\data\GongData.java", "Java", 0, 79, 8, 26, 113
"d:\panling\yuehua-plugin\src\main\java\com\xiaoxiaoowo\yuehua\data\MonsterData.java", "Java", 0, 110, 0, 35, 145
"d:\panling\yuehua-plugin\src\main\java\com\xiaoxiaoowo\yuehua\data\PetData.java", "Java", 0, 38, 0, 14, 52
"d:\panling\yuehua-plugin\src\main\java\com\xiaoxiaoowo\yuehua\data\ZhanData.java", "Java", 0, 19, 1, 12, 32
"d:\panling\yuehua-plugin\src\main\java\com\xiaoxiaoowo\yuehua\data\slot\EnderChestSlot.java", "Java", 0, 12, 0, 4, 16
"d:\panling\yuehua-plugin\src\main\java\com\xiaoxiaoowo\yuehua\data\slot\Slot.java", "Java", 0, 12, 0, 9, 21
"d:\panling\yuehua-plugin\src\main\java\com\xiaoxiaoowo\yuehua\data\slot\SlotBuilder.java", "Java", 0, 129, 0, 36, 165
"d:\panling\yuehua-plugin\src\main\java\com\xiaoxiaoowo\yuehua\data\slot\SlotWithOneActiveSkill.java", "Java", 0, 14, 0, 8, 22
"d:\panling\yuehua-plugin\src\main\java\com\xiaoxiaoowo\yuehua\data\slot\SlotWithTwoActiveSkill.java", "Java", 0, 17, 0, 6, 23
"d:\panling\yuehua-plugin\src\main\java\com\xiaoxiaoowo\yuehua\data\slot\special\BeiDouMieShen.java", "Java", 0, 15, 0, 4, 19
"d:\panling\yuehua-plugin\src\main\java\com\xiaoxiaoowo\yuehua\data\slot\special\Chong.java", "Java", 0, 11, 0, 4, 15
"d:\panling\yuehua-plugin\src\main\java\com\xiaoxiaoowo\yuehua\display\test\TestDisplay.java", "Java", 0, 127, 3, 20, 150
"d:\panling\yuehua-plugin\src\main\java\com\xiaoxiaoowo\yuehua\display\test\TestRay.java", "Java", 0, 30, 5, 11, 46
"d:\panling\yuehua-plugin\src\main\java\com\xiaoxiaoowo\yuehua\display\utils\DisPlayUtils.java", "Java", 0, 278, 88, 95, 461
"d:\panling\yuehua-plugin\src\main\java\com\xiaoxiaoowo\yuehua\display\utils\ParticleUtils.java", "Java", 0, 465, 63, 137, 665
"d:\panling\yuehua-plugin\src\main\java\com\xiaoxiaoowo\yuehua\entity\monster\east\boss\JIANXIGUIMEI.java", "Java", 0, 44, 25, 22, 91
"d:\panling\yuehua-plugin\src\main\java\com\xiaoxiaoowo\yuehua\entity\monster\east\boss\LinYouDuZhu.java", "Java", 0, 29, 21, 17, 67
"d:\panling\yuehua-plugin\src\main\java\com\xiaoxiaoowo\yuehua\entity\monster\east\boss\ZHIZHUNVWANG.java", "Java", 0, 29, 9, 11, 49
"d:\panling\yuehua-plugin\src\main\java\com\xiaoxiaoowo\yuehua\entity\monster\east\normal\ChiJianJiangShi.java", "Java", 0, 51, 25, 21, 97
"d:\panling\yuehua-plugin\src\main\java\com\xiaoxiaoowo\yuehua\entity\monster\east\normal\DuFeng.java", "Java", 0, 28, 21, 17, 66
"d:\panling\yuehua-plugin\src\main\java\com\xiaoxiaoowo\yuehua\entity\monster\east\normal\JiangShi.java", "Java", 0, 43, 25, 20, 88
"d:\panling\yuehua-plugin\src\main\java\com\xiaoxiaoowo\yuehua\entity\monster\east\normal\KuGuGongJianShou.java", "Java", 0, 50, 25, 21, 96
"d:\panling\yuehua-plugin\src\main\java\com\xiaoxiaoowo\yuehua\entity\monster\east\normal\KuLou.java", "Java", 0, 42, 25, 21, 88
"d:\panling\yuehua-plugin\src\main\java\com\xiaoxiaoowo\yuehua\entity\monster\east\normal\ZhiZhu.java", "Java", 0, 28, 21, 20, 69
"d:\panling\yuehua-plugin\src\main\java\com\xiaoxiaoowo\yuehua\entity\monster\east\normal\ZhiZhuJinYin.java", "Java", 0, 28, 21, 18, 67
"d:\panling\yuehua-plugin\src\main\java\com\xiaoxiaoowo\yuehua\entity\monster\east\rabbit\FenNuTu.java", "Java", 0, 29, 21, 17, 67
"d:\panling\yuehua-plugin\src\main\java\com\xiaoxiaoowo\yuehua\entity\monster\east\special\ShanshenShooter.java", "Java", 0, 50, 25, 20, 95
"d:\panling\yuehua-plugin\src\main\java\com\xiaoxiaoowo\yuehua\entity\monster\east\special\ShanshenSpider.java", "Java", 0, 28, 21, 17, 66
"d:\panling\yuehua-plugin\src\main\java\com\xiaoxiaoowo\yuehua\entity\monster\east\special\ShanshenZombie.java", "Java", 0, 51, 25, 21, 97
"d:\panling\yuehua-plugin\src\main\java\com\xiaoxiaoowo\yuehua\entity\monster\east\special\YaoJinShooter.java", "Java", 0, 50, 25, 21, 96
"d:\panling\yuehua-plugin\src\main\java\com\xiaoxiaoowo\yuehua\entity\monster\east\special\YaoJingMiFeng.java", "Java", 0, 28, 21, 18, 67
"d:\panling\yuehua-plugin\src\main\java\com\xiaoxiaoowo\yuehua\entity\monster\east\special\YaoJingPanda.java", "Java", 0, 29, 21, 18, 68
"d:\panling\yuehua-plugin\src\main\java\com\xiaoxiaoowo\yuehua\entity\monster\other\Renou.java", "Java", 0, 54, 17, 17, 88
"d:\panling\yuehua-plugin\src\main\java\com\xiaoxiaoowo\yuehua\entity\monster\other\Renou2.java", "Java", 0, 56, 17, 17, 90
"d:\panling\yuehua-plugin\src\main\java\com\xiaoxiaoowo\yuehua\entity\monster\other\Renou3.java", "Java", 0, 59, 17, 18, 94
"d:\panling\yuehua-plugin\src\main\java\com\xiaoxiaoowo\yuehua\entity\monster\other\TemplateMonster.java", "Java", 0, 53, 25, 21, 99
"d:\panling\yuehua-plugin\src\main\java\com\xiaoxiaoowo\yuehua\entity\monster\other\TemplateShooter.java", "Java", 0, 54, 13, 15, 82
"d:\panling\yuehua-plugin\src\main\java\com\xiaoxiaoowo\yuehua\entity\npc\chat\east\East1.java", "Java", 0, 44, 0, 9, 53
"d:\panling\yuehua-plugin\src\main\java\com\xiaoxiaoowo\yuehua\entity\npc\chat\east\East2.java", "Java", 0, 44, 0, 9, 53
"d:\panling\yuehua-plugin\src\main\java\com\xiaoxiaoowo\yuehua\entity\npc\chat\east\East3.java", "Java", 0, 44, 0, 10, 54
"d:\panling\yuehua-plugin\src\main\java\com\xiaoxiaoowo\yuehua\entity\npc\chat\east\East5.java", "Java", 0, 44, 0, 10, 54
"d:\panling\yuehua-plugin\src\main\java\com\xiaoxiaoowo\yuehua\entity\npc\chat\east\Maindragon.java", "Java", 0, 102, 3, 15, 120
"d:\panling\yuehua-plugin\src\main\java\com\xiaoxiaoowo\yuehua\entity\npc\chat\east\Re1.java", "Java", 0, 53, 1, 12, 66
"d:\panling\yuehua-plugin\src\main\java\com\xiaoxiaoowo\yuehua\entity\npc\chat\east\Re2.java", "Java", 0, 50, 0, 10, 60
"d:\panling\yuehua-plugin\src\main\java\com\xiaoxiaoowo\yuehua\entity\npc\chat\east\Renmain6.java", "Java", 0, 55, 0, 12, 67
"d:\panling\yuehua-plugin\src\main\java\com\xiaoxiaoowo\yuehua\entity\npc\chat\east\TraderInstance1.java", "Java", 0, 165, 10, 37, 212
"d:\panling\yuehua-plugin\src\main\java\com\xiaoxiaoowo\yuehua\entity\npc\chat\east\Xianmain6.java", "Java", 0, 56, 0, 10, 66
"d:\panling\yuehua-plugin\src\main\java\com\xiaoxiaoowo\yuehua\entity\npc\chat\east\Zhanmain6.java", "Java", 0, 77, 2, 13, 92
"d:\panling\yuehua-plugin\src\main\java\com\xiaoxiaoowo\yuehua\entity\npc\chat\east\Zhanmain7.java", "Java", 0, 55, 0, 9, 64
"d:\panling\yuehua-plugin\src\main\java\com\xiaoxiaoowo\yuehua\entity\npc\chat\middle\ExSword1.java", "Java", 0, 63, 2, 12, 77
"d:\panling\yuehua-plugin\src\main\java\com\xiaoxiaoowo\yuehua\entity\npc\chat\middle\ExSword2.java", "Java", 0, 51, 1, 10, 62
"d:\panling\yuehua-plugin\src\main\java\com\xiaoxiaoowo\yuehua\entity\npc\chat\middle\FengHuaLou.java", "Java", 0, 46, 0, 10, 56
"d:\panling\yuehua-plugin\src\main\java\com\xiaoxiaoowo\yuehua\entity\npc\chat\middle\LiGongGong.java", "Java", 0, 93, 3, 18, 114
"d:\panling\yuehua-plugin\src\main\java\com\xiaoxiaoowo\yuehua\entity\npc\chat\middle\Mainx.java", "Java", 0, 123, 4, 20, 147
"d:\panling\yuehua-plugin\src\main\java\com\xiaoxiaoowo\yuehua\entity\npc\chat\middle\RenHuang.java", "Java", 0, 53, 1, 11, 65
"d:\panling\yuehua-plugin\src\main\java\com\xiaoxiaoowo\yuehua\entity\npc\chat\middle\ShiRi.java", "Java", 0, 98, 3, 17, 118
"d:\panling\yuehua-plugin\src\main\java\com\xiaoxiaoowo\yuehua\entity\npc\chat\middle\YaoTong.java", "Java", 0, 53, 0, 10, 63
"d:\panling\yuehua-plugin\src\main\java\com\xiaoxiaoowo\yuehua\entity\npc\chat\middle\YuLuo.java", "Java", 0, 77, 2, 14, 93
"d:\panling\yuehua-plugin\src\main\java\com\xiaoxiaoowo\yuehua\entity\npc\chat\middle\Ze2.java", "Java", 0, 57, 0, 10, 67
"d:\panling\yuehua-plugin\src\main\java\com\xiaoxiaoowo\yuehua\entity\npc\chat\middle\Ze3.java", "Java", 0, 58, 0, 10, 68
"d:\panling\yuehua-plugin\src\main\java\com\xiaoxiaoowo\yuehua\entity\npc\chat\middlechat\Middle1.java", "Java", 0, 47, 0, 9, 56
"d:\panling\yuehua-plugin\src\main\java\com\xiaoxiaoowo\yuehua\entity\npc\chat\middlechat\Middle10.java", "Java", 0, 44, 0, 10, 54
"d:\panling\yuehua-plugin\src\main\java\com\xiaoxiaoowo\yuehua\entity\npc\chat\middlechat\Middle11.java", "Java", 0, 44, 0, 10, 54
"d:\panling\yuehua-plugin\src\main\java\com\xiaoxiaoowo\yuehua\entity\npc\chat\middlechat\Middle12.java", "Java", 0, 47, 0, 8, 55
"d:\panling\yuehua-plugin\src\main\java\com\xiaoxiaoowo\yuehua\entity\npc\chat\middlechat\Middle13.java", "Java", 0, 50, 0, 10, 60
"d:\panling\yuehua-plugin\src\main\java\com\xiaoxiaoowo\yuehua\entity\npc\chat\middlechat\Middle14.java", "Java", 0, 50, 0, 10, 60
"d:\panling\yuehua-plugin\src\main\java\com\xiaoxiaoowo\yuehua\entity\npc\chat\middlechat\Middle15.java", "Java", 0, 47, 0, 9, 56
"d:\panling\yuehua-plugin\src\main\java\com\xiaoxiaoowo\yuehua\entity\npc\chat\middlechat\Middle16.java", "Java", 0, 47, 0, 9, 56
"d:\panling\yuehua-plugin\src\main\java\com\xiaoxiaoowo\yuehua\entity\npc\chat\middlechat\Middle17.java", "Java", 0, 53, 1, 11, 65
"d:\panling\yuehua-plugin\src\main\java\com\xiaoxiaoowo\yuehua\entity\npc\chat\middlechat\Middle18.java", "Java", 0, 55, 1, 12, 68
"d:\panling\yuehua-plugin\src\main\java\com\xiaoxiaoowo\yuehua\entity\npc\chat\middlechat\Middle19.java", "Java", 0, 52, 1, 10, 63
"d:\panling\yuehua-plugin\src\main\java\com\xiaoxiaoowo\yuehua\entity\npc\chat\middlechat\Middle2.java", "Java", 0, 44, 0, 9, 53
"d:\panling\yuehua-plugin\src\main\java\com\xiaoxiaoowo\yuehua\entity\npc\chat\middlechat\Middle20.java", "Java", 0, 55, 1, 12, 68
"d:\panling\yuehua-plugin\src\main\java\com\xiaoxiaoowo\yuehua\entity\npc\chat\middlechat\Middle21.java", "Java", 0, 52, 1, 10, 63
"d:\panling\yuehua-plugin\src\main\java\com\xiaoxiaoowo\yuehua\entity\npc\chat\middlechat\Middle22.java", "Java", 0, 55, 1, 11, 67
"d:\panling\yuehua-plugin\src\main\java\com\xiaoxiaoowo\yuehua\entity\npc\chat\middlechat\Middle23.java", "Java", 0, 44, 0, 10, 54
"d:\panling\yuehua-plugin\src\main\java\com\xiaoxiaoowo\yuehua\entity\npc\chat\middlechat\Middle24.java", "Java", 0, 44, 0, 9, 53
"d:\panling\yuehua-plugin\src\main\java\com\xiaoxiaoowo\yuehua\entity\npc\chat\middlechat\Middle25.java", "Java", 0, 44, 0, 9, 53
"d:\panling\yuehua-plugin\src\main\java\com\xiaoxiaoowo\yuehua\entity\npc\chat\middlechat\Middle26.java", "Java", 0, 50, 0, 10, 60
"d:\panling\yuehua-plugin\src\main\java\com\xiaoxiaoowo\yuehua\entity\npc\chat\middlechat\Middle27.java", "Java", 0, 49, 0, 10, 59
"d:\panling\yuehua-plugin\src\main\java\com\xiaoxiaoowo\yuehua\entity\npc\chat\middlechat\Middle28.java", "Java", 0, 50, 0, 10, 60
"d:\panling\yuehua-plugin\src\main\java\com\xiaoxiaoowo\yuehua\entity\npc\chat\middlechat\Middle29.java", "Java", 0, 48, 0, 10, 58
"d:\panling\yuehua-plugin\src\main\java\com\xiaoxiaoowo\yuehua\entity\npc\chat\middlechat\Middle3.java", "Java", 0, 56, 2, 13, 71
"d:\panling\yuehua-plugin\src\main\java\com\xiaoxiaoowo\yuehua\entity\npc\chat\middlechat\Middle30.java", "Java", 0, 48, 0, 10, 58
"d:\panling\yuehua-plugin\src\main\java\com\xiaoxiaoowo\yuehua\entity\npc\chat\middlechat\Middle31.java", "Java", 0, 48, 0, 10, 58
"d:\panling\yuehua-plugin\src\main\java\com\xiaoxiaoowo\yuehua\entity\npc\chat\middlechat\Middle32.java", "Java", 0, 50, 0, 9, 59
"d:\panling\yuehua-plugin\src\main\java\com\xiaoxiaoowo\yuehua\entity\npc\chat\middlechat\Middle33.java", "Java", 0, 49, 0, 10, 59
"d:\panling\yuehua-plugin\src\main\java\com\xiaoxiaoowo\yuehua\entity\npc\chat\middlechat\Middle34.java", "Java", 0, 49, 0, 10, 59
"d:\panling\yuehua-plugin\src\main\java\com\xiaoxiaoowo\yuehua\entity\npc\chat\middlechat\Middle35.java", "Java", 0, 50, 0, 9, 59
"d:\panling\yuehua-plugin\src\main\java\com\xiaoxiaoowo\yuehua\entity\npc\chat\middlechat\Middle36.java", "Java", 0, 49, 0, 9, 58
"d:\panling\yuehua-plugin\src\main\java\com\xiaoxiaoowo\yuehua\entity\npc\chat\middlechat\Middle37.java", "Java", 0, 48, 0, 9, 57
"d:\panling\yuehua-plugin\src\main\java\com\xiaoxiaoowo\yuehua\entity\npc\chat\middlechat\Middle38.java", "Java", 0, 48, 0, 10, 58
"d:\panling\yuehua-plugin\src\main\java\com\xiaoxiaoowo\yuehua\entity\npc\chat\middlechat\Middle39.java", "Java", 0, 50, 0, 10, 60
"d:\panling\yuehua-plugin\src\main\java\com\xiaoxiaoowo\yuehua\entity\npc\chat\middlechat\Middle4.java", "Java", 0, 44, 0, 9, 53
"d:\panling\yuehua-plugin\src\main\java\com\xiaoxiaoowo\yuehua\entity\npc\chat\middlechat\Middle40.java", "Java", 0, 49, 0, 9, 58
"d:\panling\yuehua-plugin\src\main\java\com\xiaoxiaoowo\yuehua\entity\npc\chat\middlechat\Middle41.java", "Java", 0, 49, 0, 10, 59
"d:\panling\yuehua-plugin\src\main\java\com\xiaoxiaoowo\yuehua\entity\npc\chat\middlechat\Middle42.java", "Java", 0, 48, 0, 10, 58
"d:\panling\yuehua-plugin\src\main\java\com\xiaoxiaoowo\yuehua\entity\npc\chat\middlechat\Middle43.java", "Java", 0, 49, 0, 10, 59
"d:\panling\yuehua-plugin\src\main\java\com\xiaoxiaoowo\yuehua\entity\npc\chat\middlechat\Middle44.java", "Java", 0, 48, 0, 9, 57
"d:\panling\yuehua-plugin\src\main\java\com\xiaoxiaoowo\yuehua\entity\npc\chat\middlechat\Middle45.java", "Java", 0, 48, 0, 9, 57
"d:\panling\yuehua-plugin\src\main\java\com\xiaoxiaoowo\yuehua\entity\npc\chat\middlechat\Middle46.java", "Java", 0, 48, 0, 10, 58
"d:\panling\yuehua-plugin\src\main\java\com\xiaoxiaoowo\yuehua\entity\npc\chat\middlechat\Middle47.java", "Java", 0, 48, 0, 10, 58
"d:\panling\yuehua-plugin\src\main\java\com\xiaoxiaoowo\yuehua\entity\npc\chat\middlechat\Middle48.java", "Java", 0, 48, 0, 10, 58
"d:\panling\yuehua-plugin\src\main\java\com\xiaoxiaoowo\yuehua\entity\npc\chat\middlechat\Middle49.java", "Java", 0, 49, 0, 9, 58
"d:\panling\yuehua-plugin\src\main\java\com\xiaoxiaoowo\yuehua\entity\npc\chat\middlechat\Middle5.java", "Java", 0, 44, 0, 9, 53
"d:\panling\yuehua-plugin\src\main\java\com\xiaoxiaoowo\yuehua\entity\npc\chat\middlechat\Middle50.java", "Java", 0, 49, 0, 10, 59
"d:\panling\yuehua-plugin\src\main\java\com\xiaoxiaoowo\yuehua\entity\npc\chat\middlechat\Middle51.java", "Java", 0, 48, 0, 10, 58
"d:\panling\yuehua-plugin\src\main\java\com\xiaoxiaoowo\yuehua\entity\npc\chat\middlechat\Middle52.java", "Java", 0, 49, 0, 10, 59
"d:\panling\yuehua-plugin\src\main\java\com\xiaoxiaoowo\yuehua\entity\npc\chat\middlechat\Middle53.java", "Java", 0, 50, 0, 10, 60
"d:\panling\yuehua-plugin\src\main\java\com\xiaoxiaoowo\yuehua\entity\npc\chat\middlechat\Middle54.java", "Java", 0, 49, 0, 10, 59
"d:\panling\yuehua-plugin\src\main\java\com\xiaoxiaoowo\yuehua\entity\npc\chat\middlechat\Middle55.java", "Java", 0, 48, 0, 10, 58
"d:\panling\yuehua-plugin\src\main\java\com\xiaoxiaoowo\yuehua\entity\npc\chat\middlechat\Middle56.java", "Java", 0, 57, 2, 13, 72
"d:\panling\yuehua-plugin\src\main\java\com\xiaoxiaoowo\yuehua\entity\npc\chat\middlechat\Middle57.java", "Java", 0, 50, 1, 13, 64
"d:\panling\yuehua-plugin\src\main\java\com\xiaoxiaoowo\yuehua\entity\npc\chat\middlechat\Middle58.java", "Java", 0, 48, 0, 10, 58
"d:\panling\yuehua-plugin\src\main\java\com\xiaoxiaoowo\yuehua\entity\npc\chat\middlechat\Middle59.java", "Java", 0, 48, 0, 10, 58
"d:\panling\yuehua-plugin\src\main\java\com\xiaoxiaoowo\yuehua\entity\npc\chat\middlechat\Middle6.java", "Java", 0, 44, 0, 10, 54
"d:\panling\yuehua-plugin\src\main\java\com\xiaoxiaoowo\yuehua\entity\npc\chat\middlechat\Middle61.java", "Java", 0, 49, 0, 10, 59
"d:\panling\yuehua-plugin\src\main\java\com\xiaoxiaoowo\yuehua\entity\npc\chat\middlechat\Middle62.java", "Java", 0, 49, 0, 10, 59
"d:\panling\yuehua-plugin\src\main\java\com\xiaoxiaoowo\yuehua\entity\npc\chat\middlechat\Middle63.java", "Java", 0, 49, 0, 9, 58
"d:\panling\yuehua-plugin\src\main\java\com\xiaoxiaoowo\yuehua\entity\npc\chat\middlechat\Middle64.java", "Java", 0, 49, 0, 10, 59
"d:\panling\yuehua-plugin\src\main\java\com\xiaoxiaoowo\yuehua\entity\npc\chat\middlechat\Middle65.java", "Java", 0, 48, 0, 10, 58
"d:\panling\yuehua-plugin\src\main\java\com\xiaoxiaoowo\yuehua\entity\npc\chat\middlechat\Middle66.java", "Java", 0, 67, 2, 15, 84
"d:\panling\yuehua-plugin\src\main\java\com\xiaoxiaoowo\yuehua\entity\npc\chat\middlechat\Middle67.java", "Java", 0, 49, 0, 10, 59
"d:\panling\yuehua-plugin\src\main\java\com\xiaoxiaoowo\yuehua\entity\npc\chat\middlechat\Middle68.java", "Java", 0, 49, 0, 10, 59
"d:\panling\yuehua-plugin\src\main\java\com\xiaoxiaoowo\yuehua\entity\npc\chat\middlechat\Middle69.java", "Java", 0, 54, 1, 12, 67
"d:\panling\yuehua-plugin\src\main\java\com\xiaoxiaoowo\yuehua\entity\npc\chat\middlechat\Middle7.java", "Java", 0, 47, 0, 9, 56
"d:\panling\yuehua-plugin\src\main\java\com\xiaoxiaoowo\yuehua\entity\npc\chat\middlechat\Middle70.java", "Java", 0, 62, 2, 13, 77
"d:\panling\yuehua-plugin\src\main\java\com\xiaoxiaoowo\yuehua\entity\npc\chat\middlechat\Middle71.java", "Java", 0, 62, 2, 14, 78
"d:\panling\yuehua-plugin\src\main\java\com\xiaoxiaoowo\yuehua\entity\npc\chat\middlechat\Middle72.java", "Java", 0, 47, 1, 10, 58
"d:\panling\yuehua-plugin\src\main\java\com\xiaoxiaoowo\yuehua\entity\npc\chat\middlechat\Middle73.java", "Java", 0, 49, 1, 9, 59
"d:\panling\yuehua-plugin\src\main\java\com\xiaoxiaoowo\yuehua\entity\npc\chat\middlechat\Middle8.java", "Java", 0, 50, 0, 10, 60
"d:\panling\yuehua-plugin\src\main\java\com\xiaoxiaoowo\yuehua\entity\npc\chat\middlechat\Middle9.java", "Java", 0, 50, 0, 10, 60
"d:\panling\yuehua-plugin\src\main\java\com\xiaoxiaoowo\yuehua\entity\npc\chat\north\North1.java", "Java", 0, 54, 1, 11, 66
"d:\panling\yuehua-plugin\src\main\java\com\xiaoxiaoowo\yuehua\entity\npc\chat\north\North2.java", "Java", 0, 54, 1, 11, 66
"d:\panling\yuehua-plugin\src\main\java\com\xiaoxiaoowo\yuehua\entity\npc\chat\north\North3.java", "Java", 0, 54, 1, 11, 66
"d:\panling\yuehua-plugin\src\main\java\com\xiaoxiaoowo\yuehua\entity\npc\chat\north\Northm1.java", "Java", 0, 51, 2, 13, 66
"d:\panling\yuehua-plugin\src\main\java\com\xiaoxiaoowo\yuehua\entity\npc\chat\north\Northm2.java", "Java", 0, 92, 3, 15, 110
"d:\panling\yuehua-plugin\src\main\java\com\xiaoxiaoowo\yuehua\entity\npc\chat\north\Te18.java", "Java", 0, 48, 2, 10, 60
"d:\panling\yuehua-plugin\src\main\java\com\xiaoxiaoowo\yuehua\entity\npc\chat\north\Te2.java", "Java", 0, 61, 4, 13, 78
"d:\panling\yuehua-plugin\src\main\java\com\xiaoxiaoowo\yuehua\entity\npc\chat\north\Xh5.java", "Java", 0, 48, 1, 11, 60
"d:\panling\yuehua-plugin\src\main\java\com\xiaoxiaoowo\yuehua\entity\npc\chat\penglai\Mainxx.java", "Java", 0, 70, 6, 14, 90
"d:\panling\yuehua-plugin\src\main\java\com\xiaoxiaoowo\yuehua\entity\npc\chat\penglai\Penglai1.java", "Java", 0, 44, 3, 12, 59
"d:\panling\yuehua-plugin\src\main\java\com\xiaoxiaoowo\yuehua\entity\npc\chat\penglai\Penglai2.java", "Java", 0, 44, 3, 11, 58
"d:\panling\yuehua-plugin\src\main\java\com\xiaoxiaoowo\yuehua\entity\npc\chat\penglai\Penglai3.java", "Java", 0, 44, 3, 11, 58
"d:\panling\yuehua-plugin\src\main\java\com\xiaoxiaoowo\yuehua\entity\npc\chat\penglai\Penglai4.java", "Java", 0, 44, 3, 12, 59
"d:\panling\yuehua-plugin\src\main\java\com\xiaoxiaoowo\yuehua\entity\npc\chat\penglai\Penglai5.java", "Java", 0, 44, 3, 12, 59
"d:\panling\yuehua-plugin\src\main\java\com\xiaoxiaoowo\yuehua\entity\npc\chat\penglai\Penglai6.java", "Java", 0, 44, 3, 12, 59
"d:\panling\yuehua-plugin\src\main\java\com\xiaoxiaoowo\yuehua\entity\npc\chat\penglai\Se1.java", "Java", 0, 56, 2, 14, 72
"d:\panling\yuehua-plugin\src\main\java\com\xiaoxiaoowo\yuehua\entity\npc\chat\penglai\Shenmain6.java", "Java", 0, 55, 1, 11, 67
"d:\panling\yuehua-plugin\src\main\java\com\xiaoxiaoowo\yuehua\entity\npc\chat\penglai\ShouShanRen.java", "Java", 0, 96, 6, 21, 123
"d:\panling\yuehua-plugin\src\main\java\com\xiaoxiaoowo\yuehua\entity\npc\chat\penglai\Te32.java", "Java", 0, 60, 2, 12, 74
"d:\panling\yuehua-plugin\src\main\java\com\xiaoxiaoowo\yuehua\entity\npc\chat\penglai\Yaomain8.java", "Java", 0, 56, 1, 10, 67
"d:\panling\yuehua-plugin\src\main\java\com\xiaoxiaoowo\yuehua\entity\npc\chat\penglai\Yh5.java", "Java", 0, 45, 1, 10, 56
"d:\panling\yuehua-plugin\src\main\java\com\xiaoxiaoowo\yuehua\entity\npc\chat\penglai\Zhanmain8.java", "Java", 0, 53, 1, 10, 64
"d:\panling\yuehua-plugin\src\main\java\com\xiaoxiaoowo\yuehua\entity\npc\chat\qiansi\Qiansi1.java", "Java", 0, 51, 1, 10, 62
"d:\panling\yuehua-plugin\src\main\java\com\xiaoxiaoowo\yuehua\entity\npc\chat\qiansi\Qiansi10.java", "Java", 0, 53, 1, 10, 64
"d:\panling\yuehua-plugin\src\main\java\com\xiaoxiaoowo\yuehua\entity\npc\chat\qiansi\Qiansi11.java", "Java", 0, 51, 1, 10, 62
"d:\panling\yuehua-plugin\src\main\java\com\xiaoxiaoowo\yuehua\entity\npc\chat\qiansi\Qiansi12.java", "Java", 0, 51, 1, 9, 61
"d:\panling\yuehua-plugin\src\main\java\com\xiaoxiaoowo\yuehua\entity\npc\chat\qiansi\Qiansi13.java", "Java", 0, 51, 1, 10, 62
"d:\panling\yuehua-plugin\src\main\java\com\xiaoxiaoowo\yuehua\entity\npc\chat\qiansi\Qiansi14.java", "Java", 0, 51, 1, 10, 62
"d:\panling\yuehua-plugin\src\main\java\com\xiaoxiaoowo\yuehua\entity\npc\chat\qiansi\Qiansi15.java", "Java", 0, 53, 1, 10, 64
"d:\panling\yuehua-plugin\src\main\java\com\xiaoxiaoowo\yuehua\entity\npc\chat\qiansi\Qiansi16.java", "Java", 0, 53, 1, 11, 65
"d:\panling\yuehua-plugin\src\main\java\com\xiaoxiaoowo\yuehua\entity\npc\chat\qiansi\Qiansi2.java", "Java", 0, 51, 1, 10, 62
"d:\panling\yuehua-plugin\src\main\java\com\xiaoxiaoowo\yuehua\entity\npc\chat\qiansi\Qiansi3.java", "Java", 0, 51, 1, 10, 62
"d:\panling\yuehua-plugin\src\main\java\com\xiaoxiaoowo\yuehua\entity\npc\chat\qiansi\Qiansi4.java", "Java", 0, 51, 1, 10, 62
"d:\panling\yuehua-plugin\src\main\java\com\xiaoxiaoowo\yuehua\entity\npc\chat\qiansi\Qiansi5.java", "Java", 0, 51, 1, 10, 62
"d:\panling\yuehua-plugin\src\main\java\com\xiaoxiaoowo\yuehua\entity\npc\chat\qiansi\Qiansi6.java", "Java", 0, 51, 1, 9, 61
"d:\panling\yuehua-plugin\src\main\java\com\xiaoxiaoowo\yuehua\entity\npc\chat\qiansi\Qiansi7.java", "Java", 0, 51, 1, 10, 62
"d:\panling\yuehua-plugin\src\main\java\com\xiaoxiaoowo\yuehua\entity\npc\chat\qiansi\Qiansi8.java", "Java", 0, 53, 1, 10, 64
"d:\panling\yuehua-plugin\src\main\java\com\xiaoxiaoowo\yuehua\entity\npc\chat\qiansi\Qiansi9.java", "Java", 0, 53, 1, 8, 62
"d:\panling\yuehua-plugin\src\main\java\com\xiaoxiaoowo\yuehua\entity\npc\chat\qiansi\Se4.java", "Java", 0, 54, 2, 10, 66
"d:\panling\yuehua-plugin\src\main\java\com\xiaoxiaoowo\yuehua\entity\npc\chat\qiansi\Te33.java", "Java", 0, 50, 1, 11, 62
"d:\panling\yuehua-plugin\src\main\java\com\xiaoxiaoowo\yuehua\entity\npc\chat\qiansi\Zh3.java", "Java", 0, 52, 2, 11, 65
"d:\panling\yuehua-plugin\src\main\java\com\xiaoxiaoowo\yuehua\entity\npc\chat\qiansi\Zh4.java", "Java", 0, 52, 2, 11, 65
"d:\panling\yuehua-plugin\src\main\java\com\xiaoxiaoowo\yuehua\entity\npc\chat\ren\Ren1.java", "Java", 0, 50, 1, 9, 60
"d:\panling\yuehua-plugin\src\main\java\com\xiaoxiaoowo\yuehua\entity\npc\chat\ren\Ren2.java", "Java", 0, 49, 1, 10, 60
"d:\panling\yuehua-plugin\src\main\java\com\xiaoxiaoowo\yuehua\entity\npc\chat\ren\Ren3.java", "Java", 0, 48, 1, 10, 59
"d:\panling\yuehua-plugin\src\main\java\com\xiaoxiaoowo\yuehua\entity\npc\chat\ren\Ren4.java", "Java", 0, 50, 1, 8, 59
"d:\panling\yuehua-plugin\src\main\java\com\xiaoxiaoowo\yuehua\entity\npc\chat\ren\Ren5.java", "Java", 0, 48, 1, 9, 58
"d:\panling\yuehua-plugin\src\main\java\com\xiaoxiaoowo\yuehua\entity\npc\chat\south\Se3.java", "Java", 0, 54, 0, 10, 64
"d:\panling\yuehua-plugin\src\main\java\com\xiaoxiaoowo\yuehua\entity\npc\chat\south\Sh4.java", "Java", 0, 50, 0, 10, 60
"d:\panling\yuehua-plugin\src\main\java\com\xiaoxiaoowo\yuehua\entity\npc\chat\south\South1.java", "Java", 0, 47, 0, 10, 57
"d:\panling\yuehua-plugin\src\main\java\com\xiaoxiaoowo\yuehua\entity\npc\chat\south\South2.java", "Java", 0, 50, 0, 10, 60
"d:\panling\yuehua-plugin\src\main\java\com\xiaoxiaoowo\yuehua\entity\npc\chat\south\South3.java", "Java", 0, 44, 0, 10, 54
"d:\panling\yuehua-plugin\src\main\java\com\xiaoxiaoowo\yuehua\entity\npc\chat\south\South4.java", "Java", 0, 50, 0, 10, 60
"d:\panling\yuehua-plugin\src\main\java\com\xiaoxiaoowo\yuehua\entity\npc\chat\south\Southm1.java", "Java", 0, 89, 3, 16, 108
"d:\panling\yuehua-plugin\src\main\java\com\xiaoxiaoowo\yuehua\entity\npc\chat\south\Southm2.java", "Java", 0, 55, 2, 9, 66
"d:\panling\yuehua-plugin\src\main\java\com\xiaoxiaoowo\yuehua\entity\npc\chat\south\Southm3.java", "Java", 0, 70, 2, 15, 87
"d:\panling\yuehua-plugin\src\main\java\com\xiaoxiaoowo\yuehua\entity\npc\chat\south\Southm4.java", "Java", 0, 77, 2, 12, 91
"d:\panling\yuehua-plugin\src\main\java\com\xiaoxiaoowo\yuehua\entity\npc\chat\south\Te22.java", "Java", 0, 47, 1, 12, 60
"d:\panling\yuehua-plugin\src\main\java\com\xiaoxiaoowo\yuehua\entity\npc\chat\south\Tezhan2.java", "Java", 0, 76, 4, 16, 96
"d:\panling\yuehua-plugin\src\main\java\com\xiaoxiaoowo\yuehua\entity\npc\chat\south\Tezhan3.java", "Java", 0, 91, 5, 16, 112
"d:\panling\yuehua-plugin\src\main\java\com\xiaoxiaoowo\yuehua\entity\npc\chat\south\Ye2.java", "Java", 0, 48, 1, 10, 59
"d:\panling\yuehua-plugin\src\main\java\com\xiaoxiaoowo\yuehua\entity\npc\chat\south\Ze1.java", "Java", 0, 53, 3, 12, 68
"d:\panling\yuehua-plugin\src\main\java\com\xiaoxiaoowo\yuehua\entity\npc\chat\south\ZhuQueFenHun.java", "Java", 0, 46, 0, 10, 56
"d:\panling\yuehua-plugin\src\main\java\com\xiaoxiaoowo\yuehua\entity\npc\chat\start\Leading0.java", "Java", 0, 53, 1, 9, 63
"d:\panling\yuehua-plugin\src\main\java\com\xiaoxiaoowo\yuehua\entity\npc\chat\start\Leading1.java", "Java", 0, 53, 1, 10, 64
"d:\panling\yuehua-plugin\src\main\java\com\xiaoxiaoowo\yuehua\entity\npc\chat\start\Leading2.java", "Java", 0, 53, 1, 9, 63
"d:\panling\yuehua-plugin\src\main\java\com\xiaoxiaoowo\yuehua\entity\npc\chat\start\Leading3.java", "Java", 0, 52, 1, 9, 62
"d:\panling\yuehua-plugin\src\main\java\com\xiaoxiaoowo\yuehua\entity\npc\chat\start\Leading4.java", "Java", 0, 53, 1, 10, 64
"d:\panling\yuehua-plugin\src\main\java\com\xiaoxiaoowo\yuehua\entity\npc\chat\west\Rh4.java", "Java", 0, 50, 1, 12, 63
"d:\panling\yuehua-plugin\src\main\java\com\xiaoxiaoowo\yuehua\entity\npc\chat\west\Te4.java", "Java", 0, 46, 1, 12, 59
"d:\panling\yuehua-plugin\src\main\java\com\xiaoxiaoowo\yuehua\entity\npc\chat\west\West1.java", "Java", 0, 50, 1, 13, 64
"d:\panling\yuehua-plugin\src\main\java\com\xiaoxiaoowo\yuehua\entity\npc\chat\west\West3.java", "Java", 0, 49, 1, 12, 62
"d:\panling\yuehua-plugin\src\main\java\com\xiaoxiaoowo\yuehua\entity\npc\chat\west\Westm1.java", "Java", 0, 69, 2, 14, 85
"d:\panling\yuehua-plugin\src\main\java\com\xiaoxiaoowo\yuehua\entity\npc\chat\west\Westm2.java", "Java", 0, 104, 3, 18, 125
"d:\panling\yuehua-plugin\src\main\java\com\xiaoxiaoowo\yuehua\entity\npc\chat\west\Xe2.java", "Java", 0, 17, 0, 4, 21
"d:\panling\yuehua-plugin\src\main\java\com\xiaoxiaoowo\yuehua\entity\npc\chat\west\Yaomain6.java", "Java", 0, 103, 3, 17, 123
"d:\panling\yuehua-plugin\src\main\java\com\xiaoxiaoowo\yuehua\entity\npc\chat\west\Yaomain7.java", "Java", 0, 81, 2, 14, 97
"d:\panling\yuehua-plugin\src\main\java\com\xiaoxiaoowo\yuehua\entity\npc\chat\xian\Supply2.java", "Java", 0, 47, 5, 12, 64
"d:\panling\yuehua-plugin\src\main\java\com\xiaoxiaoowo\yuehua\entity\npc\chat\xian\Xe1.java", "Java", 0, 54, 6, 15, 75
"d:\panling\yuehua-plugin\src\main\java\com\xiaoxiaoowo\yuehua\entity\npc\chat\xian\Xh1.java", "Java", 0, 60, 5, 15, 80
"d:\panling\yuehua-plugin\src\main\java\com\xiaoxiaoowo\yuehua\entity\npc\chat\xian\Xh2.java", "Java", 0, 55, 5, 12, 72
"d:\panling\yuehua-plugin\src\main\java\com\xiaoxiaoowo\yuehua\entity\npc\chat\xian\Xh3.java", "Java", 0, 57, 2, 10, 69
"d:\panling\yuehua-plugin\src\main\java\com\xiaoxiaoowo\yuehua\entity\npc\chat\xian\Xian1.java", "Java", 0, 50, 5, 10, 65
"d:\panling\yuehua-plugin\src\main\java\com\xiaoxiaoowo\yuehua\entity\npc\chat\xian\Xian10.java", "Java", 0, 49, 5, 12, 66
"d:\panling\yuehua-plugin\src\main\java\com\xiaoxiaoowo\yuehua\entity\npc\chat\xian\Xian2.java", "Java", 0, 49, 5, 12, 66
"d:\panling\yuehua-plugin\src\main\java\com\xiaoxiaoowo\yuehua\entity\npc\chat\xian\Xian3.java", "Java", 0, 49, 5, 12, 66
"d:\panling\yuehua-plugin\src\main\java\com\xiaoxiaoowo\yuehua\entity\npc\chat\xian\Xian4.java", "Java", 0, 50, 5, 13, 68
"d:\panling\yuehua-plugin\src\main\java\com\xiaoxiaoowo\yuehua\entity\npc\chat\xian\Xian5.java", "Java", 0, 49, 5, 12, 66
"d:\panling\yuehua-plugin\src\main\java\com\xiaoxiaoowo\yuehua\entity\npc\chat\xian\Xian6.java", "Java", 0, 48, 5, 13, 66
"d:\panling\yuehua-plugin\src\main\java\com\xiaoxiaoowo\yuehua\entity\npc\chat\xian\Xian7.java", "Java", 0, 49, 5, 13, 67
"d:\panling\yuehua-plugin\src\main\java\com\xiaoxiaoowo\yuehua\entity\npc\chat\xian\Xian8.java", "Java", 0, 50, 5, 11, 66
"d:\panling\yuehua-plugin\src\main\java\com\xiaoxiaoowo\yuehua\entity\npc\chat\xian\Xian9.java", "Java", 0, 49, 5, 12, 66
"d:\panling\yuehua-plugin\src\main\java\com\xiaoxiaoowo\yuehua\entity\npc\chat\xian\XianMain1.java", "Java", 0, 45, 2, 10, 57
"d:\panling\yuehua-plugin\src\main\java\com\xiaoxiaoowo\yuehua\entity\npc\chat\xian\XianMain2.java", "Java", 0, 169, 5, 26, 200
"d:\panling\yuehua-plugin\src\main\java\com\xiaoxiaoowo\yuehua\entity\npc\chat\xian\XianMain3.java", "Java", 0, 49, 1, 10, 60
"d:\panling\yuehua-plugin\src\main\java\com\xiaoxiaoowo\yuehua\entity\npc\chat\xian\XianMain4.java", "Java", 0, 55, 0, 10, 65
"d:\panling\yuehua-plugin\src\main\java\com\xiaoxiaoowo\yuehua\entity\npc\chat\xian\XianTong1.java", "Java", 0, 91, 1, 23, 115
"d:\panling\yuehua-plugin\src\main\java\com\xiaoxiaoowo\yuehua\entity\npc\chat\xian\XianTong2.java", "Java", 0, 56, 1, 14, 71
"d:\panling\yuehua-plugin\src\main\java\com\xiaoxiaoowo\yuehua\entity\npc\chat\xian\XianTong3.java", "Java", 0, 62, 0, 15, 77
"d:\panling\yuehua-plugin\src\main\java\com\xiaoxiaoowo\yuehua\entity\npc\chat\xian\XianTong4.java", "Java", 0, 41, 0, 11, 52
"d:\panling\yuehua-plugin\src\main\java\com\xiaoxiaoowo\yuehua\entity\npc\chat\xian\XianTong5.java", "Java", 0, 101, 4, 29, 134
"d:\panling\yuehua-plugin\src\main\java\com\xiaoxiaoowo\yuehua\entity\npc\chat\xian\XianTong6.java", "Java", 0, 99, 4, 22, 125
"d:\panling\yuehua-plugin\src\main\java\com\xiaoxiaoowo\yuehua\entity\npc\chat\xian\XianTong7.java", "Java", 0, 85, 1, 20, 106
"d:\panling\yuehua-plugin\src\main\java\com\xiaoxiaoowo\yuehua\entity\npc\dz\ArmorChest.java", "Java", 0, 186, 4, 36, 226
"d:\panling\yuehua-plugin\src\main\java\com\xiaoxiaoowo\yuehua\entity\npc\dz\ArmorFeet.java", "Java", 0, 186, 4, 35, 225
"d:\panling\yuehua-plugin\src\main\java\com\xiaoxiaoowo\yuehua\entity\npc\dz\ArmorHead.java", "Java", 0, 186, 4, 37, 227
"d:\panling\yuehua-plugin\src\main\java\com\xiaoxiaoowo\yuehua\entity\npc\dz\ArmorLeg.java", "Java", 0, 186, 4, 36, 226
"d:\panling\yuehua-plugin\src\main\java\com\xiaoxiaoowo\yuehua\entity\npc\dz\BiWeapon.java", "Java", 0, 158, 4, 26, 188
"d:\panling\yuehua-plugin\src\main\java\com\xiaoxiaoowo\yuehua\entity\npc\dz\DUShipin.java", "Java", 0, 158, 4, 26, 188
"d:\panling\yuehua-plugin\src\main\java\com\xiaoxiaoowo\yuehua\entity\npc\dz\DanWeapon.java", "Java", 0, 86, 4, 21, 111
"d:\panling\yuehua-plugin\src\main\java\com\xiaoxiaoowo\yuehua\entity\npc\dz\Fabao1.java", "Java", 0, 119, 4, 24, 147
"d:\panling\yuehua-plugin\src\main\java\com\xiaoxiaoowo\yuehua\entity\npc\dz\Fabao2.java", "Java", 0, 119, 4, 24, 147
"d:\panling\yuehua-plugin\src\main\java\com\xiaoxiaoowo\yuehua\entity\npc\dz\Fabao3.java", "Java", 0, 119, 4, 24, 147
"d:\panling\yuehua-plugin\src\main\java\com\xiaoxiaoowo\yuehua\entity\npc\dz\GongWeapon.java", "Java", 0, 158, 4, 26, 188
"d:\panling\yuehua-plugin\src\main\java\com\xiaoxiaoowo\yuehua\entity\npc\dz\MIAOFAGE.java", "Java", 0, 40, 4, 11, 55
"d:\panling\yuehua-plugin\src\main\java\com\xiaoxiaoowo\yuehua\entity\npc\dz\MINGZHUTANG.java", "Java", 0, 114, 4, 22, 140
"d:\panling\yuehua-plugin\src\main\java\com\xiaoxiaoowo\yuehua\entity\npc\dz\TIEJIANGPU.java", "Java", 0, 111, 4, 22, 137
"d:\panling\yuehua-plugin\src\main\java\com\xiaoxiaoowo\yuehua\entity\npc\dz\XUESHIPIN.java", "Java", 0, 129, 4, 25, 158
"d:\panling\yuehua-plugin\src\main\java\com\xiaoxiaoowo\yuehua\entity\npc\dz\YIBAOLOU.java", "Java", 0, 40, 4, 11, 55
"d:\panling\yuehua-plugin\src\main\java\com\xiaoxiaoowo\yuehua\entity\npc\dz\Yiqi.java", "Java", 0, 158, 4, 26, 188
"d:\panling\yuehua-plugin\src\main\java\com\xiaoxiaoowo\yuehua\entity\npc\dz\Ys1.java", "Java", 0, 121, 4, 24, 149
"d:\panling\yuehua-plugin\src\main\java\com\xiaoxiaoowo\yuehua\entity\npc\dz\Ys2.java", "Java", 0, 121, 4, 24, 149
"d:\panling\yuehua-plugin\src\main\java\com\xiaoxiaoowo\yuehua\entity\npc\dz\Ys3.java", "Java", 0, 121, 4, 24, 149
"d:\panling\yuehua-plugin\src\main\java\com\xiaoxiaoowo\yuehua\entity\npc\dz\ZhanWeapon.java", "Java", 0, 158, 4, 26, 188
"d:\panling\yuehua-plugin\src\main\java\com\xiaoxiaoowo\yuehua\entity\npc\east\EastIngerBue.java", "Java", 0, 79, 4, 26, 109
"d:\panling\yuehua-plugin\src\main\java\com\xiaoxiaoowo\yuehua\entity\npc\east\EastQianZhuang.java", "Java", 0, 86, 4, 17, 107
"d:\panling\yuehua-plugin\src\main\java\com\xiaoxiaoowo\yuehua\entity\npc\east\LaoLieHu.java", "Java", 0, 65, 4, 15, 84
"d:\panling\yuehua-plugin\src\main\java\com\xiaoxiaoowo\yuehua\entity\npc\east\SHANSHENMIAO.java", "Java", 0, 120, 4, 25, 149
"d:\panling\yuehua-plugin\src\main\java\com\xiaoxiaoowo\yuehua\entity\npc\east\SHENMUYAOJIN.java", "Java", 0, 145, 6, 30, 181
"d:\panling\yuehua-plugin\src\main\java\com\xiaoxiaoowo\yuehua\entity\npc\food\HAIXIANFAN.java", "Java", 0, 89, 4, 23, 116
"d:\panling\yuehua-plugin\src\main\java\com\xiaoxiaoowo\yuehua\entity\npc\food\HUNCAIFAN.java", "Java", 0, 89, 4, 23, 116
"d:\panling\yuehua-plugin\src\main\java\com\xiaoxiaoowo\yuehua\entity\npc\food\MEISHIJIA.java", "Java", 0, 38, 4, 15, 57
"d:\panling\yuehua-plugin\src\main\java\com\xiaoxiaoowo\yuehua\entity\npc\food\SHUIGUOFAN.java", "Java", 0, 116, 4, 25, 145
"d:\panling\yuehua-plugin\src\main\java\com\xiaoxiaoowo\yuehua\entity\npc\food\SUSHIFAN.java", "Java", 0, 80, 4, 23, 107
"d:\panling\yuehua-plugin\src\main\java\com\xiaoxiaoowo\yuehua\entity\npc\fulin\FuLingTaiYi.java", "Java", 0, 41, 4, 11, 56
"d:\panling\yuehua-plugin\src\main\java\com\xiaoxiaoowo\yuehua\entity\npc\fulin\KEHUASHI1.java", "Java", 0, 126, 4, 12, 142
"d:\panling\yuehua-plugin\src\main\java\com\xiaoxiaoowo\yuehua\entity\npc\fulin\KEHUASHI2.java", "Java", 0, 126, 4, 12, 142
"d:\panling\yuehua-plugin\src\main\java\com\xiaoxiaoowo\yuehua\entity\npc\fulin\KEHUASHI3.java", "Java", 0, 126, 4, 12, 142
"d:\panling\yuehua-plugin\src\main\java\com\xiaoxiaoowo\yuehua\entity\npc\middle\BUMINSHI.java", "Java", 0, 125, 4, 28, 157
"d:\panling\yuehua-plugin\src\main\java\com\xiaoxiaoowo\yuehua\entity\npc\middle\CAOYAOSHOUCANGJIA.java", "Java", 0, 61, 4, 13, 78
"d:\panling\yuehua-plugin\src\main\java\com\xiaoxiaoowo\yuehua\entity\npc\middle\IngredientBuy.java", "Java", 0, 118, 4, 36, 158
"d:\panling\yuehua-plugin\src\main\java\com\xiaoxiaoowo\yuehua\entity\npc\middle\LIANDANFANGXIAOER.java", "Java", 0, 72, 4, 18, 94
"d:\panling\yuehua-plugin\src\main\java\com\xiaoxiaoowo\yuehua\entity\npc\middle\LIANDANZHANGGUI.java", "Java", 0, 41, 4, 12, 57
"d:\panling\yuehua-plugin\src\main\java\com\xiaoxiaoowo\yuehua\entity\npc\middle\MoneLootBuy2.java", "Java", 0, 79, 4, 24, 107
"d:\panling\yuehua-plugin\src\main\java\com\xiaoxiaoowo\yuehua\entity\npc\middle\MoneyLootBuy.java", "Java", 0, 102, 4, 28, 134
"d:\panling\yuehua-plugin\src\main\java\com\xiaoxiaoowo\yuehua\entity\npc\middle\MoneyLootBuy3.java", "Java", 0, 48, 4, 21, 73
"d:\panling\yuehua-plugin\src\main\java\com\xiaoxiaoowo\yuehua\entity\npc\middle\QianZhuang.java", "Java", 0, 86, 4, 17, 107
"d:\panling\yuehua-plugin\src\main\java\com\xiaoxiaoowo\yuehua\entity\npc\middle\YuanSuHuiShou.java", "Java", 0, 75, 4, 23, 102
"d:\panling\yuehua-plugin\src\main\java\com\xiaoxiaoowo\yuehua\entity\npc\middle\YuanSuZhiHuanYuan.java", "Java", 0, 113, 4, 25, 142
"d:\panling\yuehua-plugin\src\main\java\com\xiaoxiaoowo\yuehua\entity\npc\middle\ZAHUO.java", "Java", 0, 99, 4, 21, 124
"d:\panling\yuehua-plugin\src\main\java\com\xiaoxiaoowo\yuehua\entity\npc\middle\ZHIBUFANG.java", "Java", 0, 80, 4, 20, 104
"d:\panling\yuehua-plugin\src\main\java\com\xiaoxiaoowo\yuehua\entity\npc\middle\ZHINV.java", "Java", 0, 106, 4, 21, 131
"d:\panling\yuehua-plugin\src\main\java\com\xiaoxiaoowo\yuehua\entity\npc\middle\ZHONGLIECI.java", "Java", 0, 40, 4, 11, 55
"d:\panling\yuehua-plugin\src\main\java\com\xiaoxiaoowo\yuehua\entity\npc\mission\RenYinLuRen.java", "Java", 0, 36, 4, 11, 51
"d:\panling\yuehua-plugin\src\main\java\com\xiaoxiaoowo\yuehua\entity\npc\mission\ShenYinluRen.java", "Java", 0, 36, 4, 12, 52
"d:\panling\yuehua-plugin\src\main\java\com\xiaoxiaoowo\yuehua\entity\npc\mission\XianYinLuRen.java", "Java", 0, 36, 4, 12, 52
"d:\panling\yuehua-plugin\src\main\java\com\xiaoxiaoowo\yuehua\entity\npc\mission\YaoYinLuRen.java", "Java", 0, 36, 4, 11, 51
"d:\panling\yuehua-plugin\src\main\java\com\xiaoxiaoowo\yuehua\entity\npc\mission\ZhanYinLuRen.java", "Java", 0, 36, 4, 10, 50
"d:\panling\yuehua-plugin\src\main\java\com\xiaoxiaoowo\yuehua\entity\npc\north\BaiGuJing.java", "Java", 0, 64, 2, 14, 80
"d:\panling\yuehua-plugin\src\main\java\com\xiaoxiaoowo\yuehua\entity\npc\qiansigu\DAN.java", "Java", 0, 73, 4, 16, 93
"d:\panling\yuehua-plugin\src\main\java\com\xiaoxiaoowo\yuehua\entity\npc\qiansigu\ZHANGGUI.java", "Java", 0, 72, 4, 15, 91
"d:\panling\yuehua-plugin\src\main\java\com\xiaoxiaoowo\yuehua\entity\npc\south\ZuanYuanZhenRen.java", "Java", 0, 126, 5, 26, 157
"d:\panling\yuehua-plugin\src\main\java\com\xiaoxiaoowo\yuehua\entity\npc\tea\CHUYIYE.java", "Java", 0, 42, 4, 11, 57
"d:\panling\yuehua-plugin\src\main\java\com\xiaoxiaoowo\yuehua\entity\npc\tea\TINGZHI.java", "Java", 0, 42, 4, 11, 57
"d:\panling\yuehua-plugin\src\main\java\com\xiaoxiaoowo\yuehua\entity\npc\tea\XIAOER.java", "Java", 0, 57, 4, 19, 80
"d:\panling\yuehua-plugin\src\main\java\com\xiaoxiaoowo\yuehua\entity\npc\west\YuZhu.java", "Java", 0, 3, 0, 2, 5
"d:\panling\yuehua-plugin\src\main\java\com\xiaoxiaoowo\yuehua\entity\npc\yushi\Bingshuangshi.java", "Java", 0, 116, 4, 27, 147
"d:\panling\yuehua-plugin\src\main\java\com\xiaoxiaoowo\yuehua\entity\npc\yushi\Cuilvshi.java", "Java", 0, 116, 4, 27, 147
"d:\panling\yuehua-plugin\src\main\java\com\xiaoxiaoowo\yuehua\entity\npc\yushi\Dianlanshi.java", "Java", 0, 116, 4, 27, 147
"d:\panling\yuehua-plugin\src\main\java\com\xiaoxiaoowo\yuehua\entity\npc\yushi\Hongyueshi.java", "Java", 0, 116, 4, 27, 147
"d:\panling\yuehua-plugin\src\main\java\com\xiaoxiaoowo\yuehua\entity\npc\yushi\Houtushi.java", "Java", 0, 116, 4, 27, 147
"d:\panling\yuehua-plugin\src\main\java\com\xiaoxiaoowo\yuehua\entity\npc\yushi\Jinhuangshi.java", "Java", 0, 116, 4, 27, 147
"d:\panling\yuehua-plugin\src\main\java\com\xiaoxiaoowo\yuehua\entity\npc\yushi\Miyinshi.java", "Java", 0, 116, 4, 27, 147
"d:\panling\yuehua-plugin\src\main\java\com\xiaoxiaoowo\yuehua\entity\npc\yushi\Suiyanshi.java", "Java", 0, 116, 4, 27, 147
"d:\panling\yuehua-plugin\src\main\java\com\xiaoxiaoowo\yuehua\entity\npc\yushi\Tulushi.java", "Java", 0, 116, 4, 27, 147
"d:\panling\yuehua-plugin\src\main\java\com\xiaoxiaoowo\yuehua\entity\npc\yushi\Xueseshi.java", "Java", 0, 116, 4, 27, 147
"d:\panling\yuehua-plugin\src\main\java\com\xiaoxiaoowo\yuehua\entity\npc\yushi\Yanyangshi.java", "Java", 0, 116, 4, 27, 147
"d:\panling\yuehua-plugin\src\main\java\com\xiaoxiaoowo\yuehua\entity\npc\yushi\Yaochijinmu.java", "Java", 0, 41, 4, 19, 64
"d:\panling\yuehua-plugin\src\main\java\com\xiaoxiaoowo\yuehua\entity\npc\yushi\Yulushi.java", "Java", 0, 116, 4, 27, 147
"d:\panling\yuehua-plugin\src\main\java\com\xiaoxiaoowo\yuehua\entity\npc\yushi\Zijinshi.java", "Java", 0, 116, 4, 27, 147
"d:\panling\yuehua-plugin\src\main\java\com\xiaoxiaoowo\yuehua\entity\other\Pig.java", "Java", 0, 18, 5, 4, 27
"d:\panling\yuehua-plugin\src\main\java\com\xiaoxiaoowo\yuehua\entity\pet\other\FeiXianJian.java", "Java", 0, 24, 5, 7, 36
"d:\panling\yuehua-plugin\src\main\java\com\xiaoxiaoowo\yuehua\event\Inventory\Click.java", "Java", 0, 4365, 57, 616, 5038
"d:\panling\yuehua-plugin\src\main\java\com\xiaoxiaoowo\yuehua\event\Inventory\Close.java", "Java", 0, 158, 0, 17, 175
"d:\panling\yuehua-plugin\src\main\java\com\xiaoxiaoowo\yuehua\event\Inventory\Open.java", "Java", 0, 18, 0, 4, 22
"d:\panling\yuehua-plugin\src\main\java\com\xiaoxiaoowo\yuehua\event\Projectile\Hit.java", "Java", 0, 99, 5, 9, 113
"d:\panling\yuehua-plugin\src\main\java\com\xiaoxiaoowo\yuehua\event\Projectile\Launch.java", "Java", 0, 25, 0, 6, 31
"d:\panling\yuehua-plugin\src\main\java\com\xiaoxiaoowo\yuehua\event\Spawner\Spawn.java", "Java", 0, 17, 3, 8, 28
"d:\panling\yuehua-plugin\src\main\java\com\xiaoxiaoowo\yuehua\event\block\CauldronLevelChange.java", "Java", 0, 21, 0, 4, 25
"d:\panling\yuehua-plugin\src\main\java\com\xiaoxiaoowo\yuehua\event\block\Ingite.java", "Java", 0, 37, 0, 7, 44
"d:\panling\yuehua-plugin\src\main\java\com\xiaoxiaoowo\yuehua\event\entity\AddToWorld.java", "Java", 0, 149, 0, 33, 182
"d:\panling\yuehua-plugin\src\main\java\com\xiaoxiaoowo\yuehua\event\entity\Breed.java", "Java", 0, 10, 0, 4, 14
"d:\panling\yuehua-plugin\src\main\java\com\xiaoxiaoowo\yuehua\event\entity\Combust.java", "Java", 0, 17, 0, 4, 21
"d:\panling\yuehua-plugin\src\main\java\com\xiaoxiaoowo\yuehua\event\entity\Damage.java", "Java", 0, 77, 1, 31, 109
"d:\panling\yuehua-plugin\src\main\java\com\xiaoxiaoowo\yuehua\event\entity\DamageByEntity.java", "Java", 0, 741, 32, 238, 1011
"d:\panling\yuehua-plugin\src\main\java\com\xiaoxiaoowo\yuehua\event\entity\Death.java", "Java", 0, 215, 2, 36, 253
"d:\panling\yuehua-plugin\src\main\java\com\xiaoxiaoowo\yuehua\event\entity\LoadCrossBow.java", "Java", 0, 35, 1, 9, 45
"d:\panling\yuehua-plugin\src\main\java\com\xiaoxiaoowo\yuehua\event\entity\PotionSpLash.java", "Java", 0, 29, 0, 7, 36
"d:\panling\yuehua-plugin\src\main\java\com\xiaoxiaoowo\yuehua\event\entity\RegainHealth.java", "Java", 0, 33, 0, 4, 37
"d:\panling\yuehua-plugin\src\main\java\com\xiaoxiaoowo\yuehua\event\entity\RemoveFromWorld.java", "Java", 0, 34, 0, 7, 41
"d:\panling\yuehua-plugin\src\main\java\com\xiaoxiaoowo\yuehua\event\entity\ShootBow.java", "Java", 0, 139, 16, 43, 198
"d:\panling\yuehua-plugin\src\main\java\com\xiaoxiaoowo\yuehua\event\entity\SlimeSpilt.java", "Java", 0, 10, 0, 3, 13
"d:\panling\yuehua-plugin\src\main\java\com\xiaoxiaoowo\yuehua\event\entity\Transform.java", "Java", 0, 10, 0, 4, 14
"d:\panling\yuehua-plugin\src\main\java\com\xiaoxiaoowo\yuehua\event\player\ConsumeItem.java", "Java", 0, 104, 4, 29, 137
"d:\panling\yuehua-plugin\src\main\java\com\xiaoxiaoowo\yuehua\event\player\Death.java", "Java", 0, 33, 17, 12, 62
"d:\panling\yuehua-plugin\src\main\java\com\xiaoxiaoowo\yuehua\event\player\DropItem.java", "Java", 0, 17, 0, 4, 21
"d:\panling\yuehua-plugin\src\main\java\com\xiaoxiaoowo\yuehua\event\player\FlowerPotManipulate.java", "Java", 0, 19, 0, 5, 24
"d:\panling\yuehua-plugin\src\main\java\com\xiaoxiaoowo\yuehua\event\player\Interact.java", "Java", 0, 1184, 55, 184, 1423
"d:\panling\yuehua-plugin\src\main\java\com\xiaoxiaoowo\yuehua\event\player\InventorySlotChange.java", "Java", 0, 683, 112, 54, 849
"d:\panling\yuehua-plugin\src\main\java\com\xiaoxiaoowo\yuehua\event\player\Join.java", "Java", 0, 449, 14, 85, 548
"d:\panling\yuehua-plugin\src\main\java\com\xiaoxiaoowo\yuehua\event\player\LevelChange.java", "Java", 0, 240, 5, 30, 275
"d:\panling\yuehua-plugin\src\main\java\com\xiaoxiaoowo\yuehua\event\player\Login.java", "Java", 0, 23, 0, 7, 30
"d:\panling\yuehua-plugin\src\main\java\com\xiaoxiaoowo\yuehua\event\player\Quit.java", "Java", 0, 132, 1, 16, 149
"d:\panling\yuehua-plugin\src\main\java\com\xiaoxiaoowo\yuehua\event\player\Swap.java", "Java", 0, 13, 0, 3, 16
"d:\panling\yuehua-plugin\src\main\java\com\xiaoxiaoowo\yuehua\event\player\Teleport.java", "Java", 0, 19, 0, 3, 22
"d:\panling\yuehua-plugin\src\main\java\com\xiaoxiaoowo\yuehua\guis\Yh.java", "Java", 0, 928, 20, 100, 1048
"d:\panling\yuehua-plugin\src\main\java\com\xiaoxiaoowo\yuehua\guis\bank\JianDai.java", "Java", 0, 113, 0, 17, 130
"d:\panling\yuehua-plugin\src\main\java\com\xiaoxiaoowo\yuehua\guis\bank\MoneyBank.java", "Java", 0, 184, 3, 34, 221
"d:\panling\yuehua-plugin\src\main\java\com\xiaoxiaoowo\yuehua\guis\bank\YuanSuBank.java", "Java", 0, 337, 4, 70, 411
"d:\panling\yuehua-plugin\src\main\java\com\xiaoxiaoowo\yuehua\guis\dz\DuanZao.java", "Java", 0, 364, 0, 70, 434
"d:\panling\yuehua-plugin\src\main\java\com\xiaoxiaoowo\yuehua\guis\dz\HuiShou.java", "Java", 0, 80, 0, 13, 93
"d:\panling\yuehua-plugin\src\main\java\com\xiaoxiaoowo\yuehua\guis\dz\Recipe.java", "Java", 0, 281, 2, 85, 368
"d:\panling\yuehua-plugin\src\main\java\com\xiaoxiaoowo\yuehua\guis\mission\PanLing.java", "Java", 0, 153, 0, 24, 177
"d:\panling\yuehua-plugin\src\main\java\com\xiaoxiaoowo\yuehua\guis\mission\Task.java", "Java", 0, 202, 1, 31, 234
"d:\panling\yuehua-plugin\src\main\java\com\xiaoxiaoowo\yuehua\guis\mission\XuanShang.java", "Java", 0, 75, 0, 17, 92
"d:\panling\yuehua-plugin\src\main\java\com\xiaoxiaoowo\yuehua\guis\op\OpGui.java", "Java", 0, 16, 0, 7, 23
"d:\panling\yuehua-plugin\src\main\java\com\xiaoxiaoowo\yuehua\guis\op\OpTp.java", "Java", 0, 52, 0, 10, 62
"d:\panling\yuehua-plugin\src\main\java\com\xiaoxiaoowo\yuehua\guis\other\Advancenment.java", "Java", 0, 126, 18, 35, 179
"d:\panling\yuehua-plugin\src\main\java\com\xiaoxiaoowo\yuehua\guis\other\Shichang.java", "Java", 0, 77, 13, 17, 107
"d:\panling\yuehua-plugin\src\main\java\com\xiaoxiaoowo\yuehua\items\Book.java", "Java", 0, 393, 0, 52, 445
"d:\panling\yuehua-plugin\src\main\java\com\xiaoxiaoowo\yuehua\items\PINZHENG.java", "Java", 0, 813, 10, 77, 900
"d:\panling\yuehua-plugin\src\main\java\com\xiaoxiaoowo\yuehua\items\Skill.java", "Java", 0, 13, 0, 4, 17
"d:\panling\yuehua-plugin\src\main\java\com\xiaoxiaoowo\yuehua\items\dz\Core.java", "Java", 0, 3685, 61, 703, 4449
"d:\panling\yuehua-plugin\src\main\java\com\xiaoxiaoowo\yuehua\items\dz\FuLing.java", "Java", 0, 862, 13, 90, 965
"d:\panling\yuehua-plugin\src\main\java\com\xiaoxiaoowo\yuehua\items\dz\Ingredient.java", "Java", 0, 885, 30, 97, 1012
"d:\panling\yuehua-plugin\src\main\java\com\xiaoxiaoowo\yuehua\items\dz\TehuaShui.java", "Java", 0, 316, 0, 82, 398
"d:\panling\yuehua-plugin\src\main\java\com\xiaoxiaoowo\yuehua\items\dz\YuShi.java", "Java", 0, 1575, 13, 169, 1757
"d:\panling\yuehua-plugin\src\main\java\com\xiaoxiaoowo\yuehua\items\dz\YuanSu.java", "Java", 0, 223, 4, 38, 265
"d:\panling\yuehua-plugin\src\main\java\com\xiaoxiaoowo\yuehua\items\liandan\Dan.java", "Java", 0, 121, 11, 38, 170
"d:\panling\yuehua-plugin\src\main\java\com\xiaoxiaoowo\yuehua\items\liandan\Herb.java", "Java", 0, 196, 4, 24, 224
"d:\panling\yuehua-plugin\src\main\java\com\xiaoxiaoowo\yuehua\items\monsterzhuangbei\Boot.java", "Java", 0, 177, 0, 30, 207
"d:\panling\yuehua-plugin\src\main\java\com\xiaoxiaoowo\yuehua\items\monsterzhuangbei\Bow.java", "Java", 0, 71, 0, 19, 90
"d:\panling\yuehua-plugin\src\main\java\com\xiaoxiaoowo\yuehua\items\monsterzhuangbei\Chest.java", "Java", 0, 177, 0, 31, 208
"d:\panling\yuehua-plugin\src\main\java\com\xiaoxiaoowo\yuehua\items\monsterzhuangbei\Helmet.java", "Java", 0, 109, 0, 27, 136
"d:\panling\yuehua-plugin\src\main\java\com\xiaoxiaoowo\yuehua\items\monsterzhuangbei\Leg.java", "Java", 0, 93, 0, 29, 122
"d:\panling\yuehua-plugin\src\main\java\com\xiaoxiaoowo\yuehua\items\monsterzhuangbei\Weapon.java", "Java", 0, 469, 23, 144, 636
"d:\panling\yuehua-plugin\src\main\java\com\xiaoxiaoowo\yuehua\items\other\Collection.java", "Java", 0, 157, 0, 31, 188
"d:\panling\yuehua-plugin\src\main\java\com\xiaoxiaoowo\yuehua\items\other\Feather.java", "Java", 0, 203, 0, 34, 237
"d:\panling\yuehua-plugin\src\main\java\com\xiaoxiaoowo\yuehua\items\other\Fish.java", "Java", 0, 92, 0, 14, 106
"d:\panling\yuehua-plugin\src\main\java\com\xiaoxiaoowo\yuehua\items\other\Food.java", "Java", 0, 868, 8, 87, 963
"d:\panling\yuehua-plugin\src\main\java\com\xiaoxiaoowo\yuehua\items\other\FuBen.java", "Java", 0, 144, 2, 17, 163
"d:\panling\yuehua-plugin\src\main\java\com\xiaoxiaoowo\yuehua\items\other\Mission.java", "Java", 0, 113, 0, 19, 132
"d:\panling\yuehua-plugin\src\main\java\com\xiaoxiaoowo\yuehua\items\other\Money.java", "Java", 0, 94, 0, 22, 116
"d:\panling\yuehua-plugin\src\main\java\com\xiaoxiaoowo\yuehua\items\other\MoneyLoot.java", "Java", 0, 202, 6, 55, 263
"d:\panling\yuehua-plugin\src\main\java\com\xiaoxiaoowo\yuehua\items\other\Other.java", "Java", 0, 64, 0, 18, 82
"d:\panling\yuehua-plugin\src\main\java\com\xiaoxiaoowo\yuehua\items\other\RaceProvince.java", "Java", 0, 85, 0, 25, 110
"d:\panling\yuehua-plugin\src\main\java\com\xiaoxiaoowo\yuehua\items\other\XP.java", "Java", 0, 105, 1, 21, 127
"d:\panling\yuehua-plugin\src\main\java\com\xiaoxiaoowo\yuehua\items\zhuangbei\ArmorChest.java", "Java", 0, 1011, 4, 31, 1046
"d:\panling\yuehua-plugin\src\main\java\com\xiaoxiaoowo\yuehua\items\zhuangbei\ArmorFeet.java", "Java", 0, 990, 4, 32, 1026
"d:\panling\yuehua-plugin\src\main\java\com\xiaoxiaoowo\yuehua\items\zhuangbei\ArmorHead.java", "Java", 0, 999, 4, 61, 1064
"d:\panling\yuehua-plugin\src\main\java\com\xiaoxiaoowo\yuehua\items\zhuangbei\ArmorLeg.java", "Java", 0, 999, 4, 36, 1039
"d:\panling\yuehua-plugin\src\main\java\com\xiaoxiaoowo\yuehua\items\zhuangbei\BiWeapon.java", "Java", 0, 866, 3, 68, 937
"d:\panling\yuehua-plugin\src\main\java\com\xiaoxiaoowo\yuehua\items\zhuangbei\Fabao.java", "Java", 0, 1360, 12, 106, 1478
"d:\panling\yuehua-plugin\src\main\java\com\xiaoxiaoowo\yuehua\items\zhuangbei\Shipin.java", "Java", 0, 2202, 0, 181, 2383
"d:\panling\yuehua-plugin\src\main\java\com\xiaoxiaoowo\yuehua\items\zhuangbei\Weapon.java", "Java", 0, 1558, 10, 84, 1652
"d:\panling\yuehua-plugin\src\main\java\com\xiaoxiaoowo\yuehua\items\zhuangbei\YiQi.java", "Java", 0, 624, 3, 51, 678
"d:\panling\yuehua-plugin\src\main\java\com\xiaoxiaoowo\yuehua\jineng\DoJiNeng.java", "Java", 0, 183, 0, 24, 207
"d:\panling\yuehua-plugin\src\main\java\com\xiaoxiaoowo\yuehua\jineng\dan\zhenfa\Huo.java", "Java", 0, 32, 0, 10, 42
"d:\panling\yuehua-plugin\src\main\java\com\xiaoxiaoowo\yuehua\jineng\dan\zhenfa\Jin.java", "Java", 0, 53, 0, 19, 72
"d:\panling\yuehua-plugin\src\main\java\com\xiaoxiaoowo\yuehua\jineng\dan\zhenfa\Mu.java", "Java", 0, 24, 0, 9, 33
"d:\panling\yuehua-plugin\src\main\java\com\xiaoxiaoowo\yuehua\jineng\dan\zhenfa\Shui.java", "Java", 0, 28, 0, 10, 38
"d:\panling\yuehua-plugin\src\main\java\com\xiaoxiaoowo\yuehua\jineng\dan\zhenfa\Tu.java", "Java", 0, 22, 0, 9, 31
"d:\panling\yuehua-plugin\src\main\java\com\xiaoxiaoowo\yuehua\jineng\gong\biweapon\HeiTieChong.java", "Java", 0, 90, 2, 21, 113
"d:\panling\yuehua-plugin\src\main\java\com\xiaoxiaoowo\yuehua\jineng\gong\biweapon\HuangTongChong.java", "Java", 0, 92, 2, 19, 113
"d:\panling\yuehua-plugin\src\main\java\com\xiaoxiaoowo\yuehua\jineng\gong\weapon\juji\BeiDouMieShenGong.java", "Java", 0, 33, 0, 6, 39
"d:\panling\yuehua-plugin\src\main\java\com\xiaoxiaoowo\yuehua\jineng\gong\weapon\juji\QinTongGong.java", "Java", 0, 33, 0, 5, 38
"d:\panling\yuehua-plugin\src\main\java\com\xiaoxiaoowo\yuehua\jineng\gong\weapon\juji\TengMuGong.java", "Java", 0, 33, 0, 5, 38
"d:\panling\yuehua-plugin\src\main\java\com\xiaoxiaoowo\yuehua\jineng\gong\weapon\juji\YanTieGong.java", "Java", 0, 33, 0, 5, 38
"d:\panling\yuehua-plugin\src\main\java\com\xiaoxiaoowo\yuehua\jineng\gong\weapon\juji\ZhongChuiGong.java", "Java", 0, 33, 0, 5, 38
"d:\panling\yuehua-plugin\src\main\java\com\xiaoxiaoowo\yuehua\jineng\gong\weapon\lingjian\FuRongGong.java", "Java", 0, 39, 0, 8, 47
"d:\panling\yuehua-plugin\src\main\java\com\xiaoxiaoowo\yuehua\jineng\gong\weapon\lingjian\HongLuanGong.java", "Java", 0, 40, 0, 6, 46
"d:\panling\yuehua-plugin\src\main\java\com\xiaoxiaoowo\yuehua\jineng\gong\weapon\lingjian\SheTianZhuiYueGong.java", "Java", 0, 39, 0, 6, 45
"d:\panling\yuehua-plugin\src\main\java\com\xiaoxiaoowo\yuehua\jineng\gong\weapon\lingjian\TianQiongGong.java", "Java", 0, 39, 0, 5, 44
"d:\panling\yuehua-plugin\src\main\java\com\xiaoxiaoowo\yuehua\jineng\gong\weapon\youxia\HeiTieNu.java", "Java", 0, 27, 0, 5, 32
"d:\panling\yuehua-plugin\src\main\java\com\xiaoxiaoowo\yuehua\jineng\gong\weapon\youxia\HongLinNu.java", "Java", 0, 41, 0, 6, 47
"d:\panling\yuehua-plugin\src\main\java\com\xiaoxiaoowo\yuehua\jineng\gong\weapon\youxia\JiaoLongNu.java", "Java", 0, 64, 0, 8, 72
"d:\panling\yuehua-plugin\src\main\java\com\xiaoxiaoowo\yuehua\jineng\gong\weapon\youxia\RiYueLiuXinNu.java", "Java", 0, 16, 0, 5, 21
"d:\panling\yuehua-plugin\src\main\java\com\xiaoxiaoowo\yuehua\jineng\zhan\biweapon\FeiRen.java", "Java", 0, 78, 1, 15, 94
"d:\panling\yuehua-plugin\src\main\java\com\xiaoxiaoowo\yuehua\jineng\zhan\biweapon\JinRuiFeiRen.java", "Java", 0, 82, 1, 15, 98
"d:\panling\yuehua-plugin\src\main\java\com\xiaoxiaoowo\yuehua\jineng\zhan\weapon\jinzhong\ChiTongJian.java", "Java", 0, 40, 0, 7, 47
"d:\panling\yuehua-plugin\src\main\java\com\xiaoxiaoowo\yuehua\jineng\zhan\weapon\jinzhong\KunLunFeiXianJian.java", "Java", 0, 63, 0, 13, 76
"d:\panling\yuehua-plugin\src\main\java\com\xiaoxiaoowo\yuehua\jineng\zhan\weapon\jinzhong\QinTongJian.java", "Java", 0, 31, 0, 6, 37
"d:\panling\yuehua-plugin\src\main\java\com\xiaoxiaoowo\yuehua\jineng\zhan\weapon\jinzhong\TaiJiJian.java", "Java", 0, 49, 1, 7, 57
"d:\panling\yuehua-plugin\src\main\java\com\xiaoxiaoowo\yuehua\jineng\zhan\weapon\pojun\JinGuaChui.java", "Java", 0, 19, 0, 4, 23
"d:\panling\yuehua-plugin\src\main\java\com\xiaoxiaoowo\yuehua\jineng\zhan\weapon\pojun\KaiShanDao.java", "Java", 0, 19, 0, 4, 23
"d:\panling\yuehua-plugin\src\main\java\com\xiaoxiaoowo\yuehua\jineng\zhan\weapon\pojun\PoKongFu.java", "Java", 0, 19, 0, 4, 23
"d:\panling\yuehua-plugin\src\main\java\com\xiaoxiaoowo\yuehua\jineng\zhan\weapon\pojun\SanBaoYuRuYi.java", "Java", 0, 19, 0, 4, 23
"d:\panling\yuehua-plugin\src\main\java\com\xiaoxiaoowo\yuehua\jineng\zhan\weapon\pojun\TaoMuJian.java", "Java", 0, 29, 0, 6, 35
"d:\panling\yuehua-plugin\src\main\java\com\xiaoxiaoowo\yuehua\jineng\zhan\weapon\tanyun\HongYinQiang.java", "Java", 0, 38, 0, 11, 49
"d:\panling\yuehua-plugin\src\main\java\com\xiaoxiaoowo\yuehua\jineng\zhan\weapon\tanyun\HuTouZhanJinQiang.java", "Java", 0, 55, 0, 14, 69
"d:\panling\yuehua-plugin\src\main\java\com\xiaoxiaoowo\yuehua\jineng\zhan\weapon\tanyun\YinYueQiang.java", "Java", 0, 28, 0, 9, 37
"d:\panling\yuehua-plugin\src\main\java\com\xiaoxiaoowo\yuehua\jineng\zhan\weapon\tanyun\YouLongQiang.java", "Java", 0, 54, 0, 9, 63
"d:\panling\yuehua-plugin\src\main\java\com\xiaoxiaoowo\yuehua\shilian\huancheng\HuanCheng.java", "Java", 0, 103, 1, 25, 129
"d:\panling\yuehua-plugin\src\main\java\com\xiaoxiaoowo\yuehua\system\Act.java", "Java", 0, 429, 1, 86, 516
"d:\panling\yuehua-plugin\src\main\java\com\xiaoxiaoowo\yuehua\system\Buff.java", "Java", 0, 600, 0, 66, 666
"d:\panling\yuehua-plugin\src\main\java\com\xiaoxiaoowo\yuehua\system\Cure.java", "Java", 0, 102, 5, 18, 125
"d:\panling\yuehua-plugin\src\main\java\com\xiaoxiaoowo\yuehua\system\Damage.java", "Java", 0, 176, 327, 60, 563
"d:\panling\yuehua-plugin\src\main\java\com\xiaoxiaoowo\yuehua\system\DataContainer.java", "Java", 0, 273, 25, 90, 388
"d:\panling\yuehua-plugin\src\main\java\com\xiaoxiaoowo\yuehua\system\Init.java", "Java", 0, 145, 0, 34, 179
"d:\panling\yuehua-plugin\src\main\java\com\xiaoxiaoowo\yuehua\system\Team.java", "Java", 0, 33, 1, 11, 45
"d:\panling\yuehua-plugin\src\main\java\com\xiaoxiaoowo\yuehua\system\act\ActFuling.java", "Java", 0, 837, 0, 106, 943
"d:\panling\yuehua-plugin\src\main\java\com\xiaoxiaoowo\yuehua\system\act\ActYuShi.java", "Java", 0, 1660, 0, 236, 1896
"d:\panling\yuehua-plugin\src\main\java\com\xiaoxiaoowo\yuehua\system\dz\Fabao.java", "Java", 0, 35, 3, 9, 47
"d:\panling\yuehua-plugin\src\main\java\com\xiaoxiaoowo\yuehua\system\dz\Help.java", "Java", 0, 39, 2, 8, 49
"d:\panling\yuehua-plugin\src\main\java\com\xiaoxiaoowo\yuehua\system\dz\LianDan.java", "Java", 0, 62, 6, 10, 78
"d:\panling\yuehua-plugin\src\main\java\com\xiaoxiaoowo\yuehua\system\dz\Shipin.java", "Java", 0, 27, 3, 5, 35
"d:\panling\yuehua-plugin\src\main\java\com\xiaoxiaoowo\yuehua\system\dz\TieJiangPu.java", "Java", 0, 51, 4, 21, 76
"d:\panling\yuehua-plugin\src\main\java\com\xiaoxiaoowo\yuehua\system\dz\Yiqi.java", "Java", 0, 35, 3, 8, 46
"d:\panling\yuehua-plugin\src\main\java\com\xiaoxiaoowo\yuehua\system\handleMonsters\DoMonsterAttack.java", "Java", 0, 58, 0, 15, 73
"d:\panling\yuehua-plugin\src\main\java\com\xiaoxiaoowo\yuehua\system\handleMonsters\DoMonsterAttacked.java", "Java", 0, 41, 0, 12, 53
"d:\panling\yuehua-plugin\src\main\java\com\xiaoxiaoowo\yuehua\system\handleMonsters\DoMonsterDeath.java", "Java", 0, 11, 0, 8, 19
"d:\panling\yuehua-plugin\src\main\java\com\xiaoxiaoowo\yuehua\system\handleMonsters\DoMonsterMoFaAttacked.java", "Java", 0, 20, 0, 4, 24
"d:\panling\yuehua-plugin\src\main\java\com\xiaoxiaoowo\yuehua\system\handleMonsters\DoMonsterShoot.java", "Java", 0, 9, 0, 4, 13
"d:\panling\yuehua-plugin\src\main\java\com\xiaoxiaoowo\yuehua\system\handleMonsters\DoMonsterWuLiAttacked.java", "Java", 0, 78, 0, 17, 95
"d:\panling\yuehua-plugin\src\main\java\com\xiaoxiaoowo\yuehua\system\handleObsevers\DoAttackObserver.java", "Java", 0, 207, 1, 24, 232
"d:\panling\yuehua-plugin\src\main\java\com\xiaoxiaoowo\yuehua\system\handleObsevers\DoAttackedObserver.java", "Java", 0, 254, 0, 53, 307
"d:\panling\yuehua-plugin\src\main\java\com\xiaoxiaoowo\yuehua\system\handleObsevers\DoBaojiObserver.java", "Java", 0, 16, 0, 5, 21
"d:\panling\yuehua-plugin\src\main\java\com\xiaoxiaoowo\yuehua\system\handleObsevers\DoCuredObserver.java", "Java", 0, 14, 0, 5, 19
"d:\panling\yuehua-plugin\src\main\java\com\xiaoxiaoowo\yuehua\system\handleObsevers\DoDeathObserver.java", "Java", 0, 13, 0, 5, 18
"d:\panling\yuehua-plugin\src\main\java\com\xiaoxiaoowo\yuehua\system\handleObsevers\DoHitObserver.java", "Java", 0, 160, 0, 36, 196
"d:\panling\yuehua-plugin\src\main\java\com\xiaoxiaoowo\yuehua\system\handleObsevers\DoHuDunObserver.java", "Java", 0, 14, 0, 4, 18
"d:\panling\yuehua-plugin\src\main\java\com\xiaoxiaoowo\yuehua\system\handleObsevers\DoJiNengObservers.java", "Java", 0, 54, 1, 12, 67
"d:\panling\yuehua-plugin\src\main\java\com\xiaoxiaoowo\yuehua\system\handleObsevers\DoKillMonsterObserver.java", "Java", 0, 665, 0, 59, 724
"d:\panling\yuehua-plugin\src\main\java\com\xiaoxiaoowo\yuehua\system\handleObsevers\DoPlayerProjectileObserver.java", "Java", 0, 475, 3, 76, 554
"d:\panling\yuehua-plugin\src\main\java\com\xiaoxiaoowo\yuehua\system\handleObsevers\DoZhenfaObserver.java", "Java", 0, 53, 1, 14, 68
"d:\panling\yuehua-plugin\src\main\java\com\xiaoxiaoowo\yuehua\system\handlePets\DoPetAttack.java", "Java", 0, 17, 0, 4, 21
"d:\panling\yuehua-plugin\src\main\java\com\xiaoxiaoowo\yuehua\system\handlePets\DoPetAttacked.java", "Java", 0, 12, 0, 4, 16
"d:\panling\yuehua-plugin\src\main\java\com\xiaoxiaoowo\yuehua\system\handlePets\DoPetDeath.java", "Java", 0, 20, 0, 6, 26
"d:\panling\yuehua-plugin\src\main\java\com\xiaoxiaoowo\yuehua\system\handlePets\DoPetShoot.java", "Java", 0, 9, 0, 5, 14
"d:\panling\yuehua-plugin\src\main\java\com\xiaoxiaoowo\yuehua\task\check\DayOfWeek.java", "Java", 0, 29, 0, 6, 35
"d:\panling\yuehua-plugin\src\main\java\com\xiaoxiaoowo\yuehua\task\check\Fulong.java", "Java", 0, 29, 0, 6, 35
"d:\panling\yuehua-plugin\src\main\java\com\xiaoxiaoowo\yuehua\task\check\Month.java", "Java", 0, 29, 0, 6, 35
"d:\panling\yuehua-plugin\src\main\java\com\xiaoxiaoowo\yuehua\task\check\Num.java", "Java", 0, 31, 0, 8, 39
"d:\panling\yuehua-plugin\src\main\java\com\xiaoxiaoowo\yuehua\task\check\Xiaoxiao.java", "Java", 0, 29, 0, 6, 35
"d:\panling\yuehua-plugin\src\main\java\com\xiaoxiaoowo\yuehua\task\check\Year.java", "Java", 0, 29, 0, 6, 35
"d:\panling\yuehua-plugin\src\main\java\com\xiaoxiaoowo\yuehua\task\hujia\Xie1.java", "Java", 0, 37, 0, 8, 45
"d:\panling\yuehua-plugin\src\main\java\com\xiaoxiaoowo\yuehua\task\hujia\Xie2345.java", "Java", 0, 43, 1, 13, 57
"d:\panling\yuehua-plugin\src\main\java\com\xiaoxiaoowo\yuehua\task\hujia\Xiong1.java", "Java", 0, 44, 0, 13, 57
"d:\panling\yuehua-plugin\src\main\java\com\xiaoxiaoowo\yuehua\task\hujia\Xiong2345.java", "Java", 0, 42, 0, 12, 54
"d:\panling\yuehua-plugin\src\main\java\com\xiaoxiaoowo\yuehua\task\other\ContinueLineDamage.java", "Java", 0, 39, 0, 9, 48
"d:\panling\yuehua-plugin\src\main\java\com\xiaoxiaoowo\yuehua\task\other\ContinueRangeDamage.java", "Java", 0, 40, 0, 8, 48
"d:\panling\yuehua-plugin\src\main\java\com\xiaoxiaoowo\yuehua\task\other\ContinuedLoseHp.java", "Java", 0, 40, 0, 13, 53
"d:\panling\yuehua-plugin\src\main\java\com\xiaoxiaoowo\yuehua\task\other\DrawProjectile.java", "Java", 0, 60, 0, 14, 74
"d:\panling\yuehua-plugin\src\main\java\com\xiaoxiaoowo\yuehua\task\other\LandDu.java", "Java", 0, 29, 1, 8, 38
"d:\panling\yuehua-plugin\src\main\java\com\xiaoxiaoowo\yuehua\task\other\ReflectProjectile.java", "Java", 0, 63, 0, 19, 82
"d:\panling\yuehua-plugin\src\main\java\com\xiaoxiaoowo\yuehua\task\other\SaleTask.java", "Java", 0, 113, 1, 20, 134
"d:\panling\yuehua-plugin\src\main\java\com\xiaoxiaoowo\yuehua\task\other\ShuiDu.java", "Java", 0, 28, 1, 8, 37
"d:\panling\yuehua-plugin\src\main\java\com\xiaoxiaoowo\yuehua\task\player\BGM.java", "Java", 0, 25, 0, 7, 32
"d:\panling\yuehua-plugin\src\main\java\com\xiaoxiaoowo\yuehua\task\player\DisplayHp.java", "Java", 0, 101, 0, 25, 126
"d:\panling\yuehua-plugin\src\main\java\com\xiaoxiaoowo\yuehua\task\regainAttribute\RegainAttack.java", "Java", 0, 24, 0, 7, 31
"d:\panling\yuehua-plugin\src\main\java\com\xiaoxiaoowo\yuehua\task\regainAttribute\RegainFakang.java", "Java", 0, 24, 0, 7, 31
"d:\panling\yuehua-plugin\src\main\java\com\xiaoxiaoowo\yuehua\task\regainAttribute\RegainGedang.java", "Java", 0, 24, 0, 6, 30
"d:\panling\yuehua-plugin\src\main\java\com\xiaoxiaoowo\yuehua\task\regainAttribute\RegainHujia.java", "Java", 0, 24, 0, 6, 30
"d:\panling\yuehua-plugin\src\main\java\com\xiaoxiaoowo\yuehua\task\regainAttribute\RegainPofa.java", "Java", 0, 24, 0, 7, 31
"d:\panling\yuehua-plugin\src\main\java\com\xiaoxiaoowo\yuehua\task\regainAttribute\RegainPojia.java", "Java", 0, 24, 0, 8, 32
"d:\panling\yuehua-plugin\src\main\java\com\xiaoxiaoowo\yuehua\task\regainAttribute\RegainRenxing.java", "Java", 0, 24, 0, 6, 30
"d:\panling\yuehua-plugin\src\main\java\com\xiaoxiaoowo\yuehua\task\regainAttribute\RegainShengJi.java", "Java", 0, 24, 0, 7, 31
"d:\panling\yuehua-plugin\src\main\java\com\xiaoxiaoowo\yuehua\task\regainAttribute\XuanYun.java", "Java", 0, 24, 0, 8, 32
"d:\panling\yuehua-plugin\src\main\java\com\xiaoxiaoowo\yuehua\task\weapon\HongYinQiangFire.java", "Java", 0, 44, 0, 12, 56
"d:\panling\yuehua-plugin\src\main\java\com\xiaoxiaoowo\yuehua\task\weapon\PoKongFu.java", "Java", 0, 40, 0, 12, 52
"d:\panling\yuehua-plugin\src\main\java\com\xiaoxiaoowo\yuehua\task\weapon\SheTian.java", "Java", 0, 23, 1, 6, 30
"d:\panling\yuehua-plugin\src\main\java\com\xiaoxiaoowo\yuehua\task\weapon\YouLong.java", "Java", 0, 32, 0, 8, 40
"d:\panling\yuehua-plugin\src\main\java\com\xiaoxiaoowo\yuehua\task\weapon\YouLongShui.java", "Java", 0, 42, 1, 10, 53
"d:\panling\yuehua-plugin\src\main\java\com\xiaoxiaoowo\yuehua\task\yiqi\LAOZHANSHIDUNPAI.java", "Java", 0, 26, 0, 10, 36
"d:\panling\yuehua-plugin\src\main\java\com\xiaoxiaoowo\yuehua\utils\AdvancementSet.java", "Java", 0, 1158, 54, 213, 1425
"d:\panling\yuehua-plugin\src\main\java\com\xiaoxiaoowo\yuehua\utils\Check.java", "Java", 0, 50, 0, 13, 63
"d:\panling\yuehua-plugin\src\main\java\com\xiaoxiaoowo\yuehua\utils\ComponentSet.java", "Java", 0, 55, 0, 13, 68
"d:\panling\yuehua-plugin\src\main\java\com\xiaoxiaoowo\yuehua\utils\GetEntity.java", "Java", 0, 1701, 165, 199, 2065
"d:\panling\yuehua-plugin\src\main\java\com\xiaoxiaoowo\yuehua\utils\LevelLeaderBoard.java", "Java", 0, 20, 0, 6, 26
"d:\panling\yuehua-plugin\src\main\java\com\xiaoxiaoowo\yuehua\utils\LocationCheck.java", "Java", 0, 198, 45, 43, 286
"d:\panling\yuehua-plugin\src\main\java\com\xiaoxiaoowo\yuehua\utils\LocationSet.java", "Java", 0, 85, 1, 4, 90
"d:\panling\yuehua-plugin\src\main\java\com\xiaoxiaoowo\yuehua\utils\MoveEntity.java", "Java", 0, 206, 26, 58, 290
"d:\panling\yuehua-plugin\src\main\java\com\xiaoxiaoowo\yuehua\utils\MySocket.java", "Java", 0, 229, 6, 42, 277
"d:\panling\yuehua-plugin\src\main\java\com\xiaoxiaoowo\yuehua\utils\PlaySound.java", "Java", 0, 182, 0, 65, 247
"d:\panling\yuehua-plugin\src\main\java\com\xiaoxiaoowo\yuehua\utils\RandomChest.java", "Java", 0, 206, 0, 23, 229
"d:\panling\yuehua-plugin\src\main\java\com\xiaoxiaoowo\yuehua\utils\SQL.java", "Java", 0, 2892, 79, 465, 3436
"d:\panling\yuehua-plugin\src\main\java\com\xiaoxiaoowo\yuehua\utils\Scheduler.java", "Java", 0, 40, 1, 14, 55
"d:\panling\yuehua-plugin\src\main\java\com\xiaoxiaoowo\yuehua\utils\SendInformation.java", "Java", 0, 80, 0, 26, 106
"d:\panling\yuehua-plugin\src\main\java\com\xiaoxiaoowo\yuehua\utils\Transfer.java", "Java", 0, 64, 0, 48, 112
"d:\panling\yuehua-plugin\src\main\java\com\xiaoxiaoowo\yuehua\utils\ZeroAttributeModifier.java", "Java", 0, 33, 0, 9, 42
"d:\panling\yuehua-plugin\src\main\java\com\xiaoxiaoowo\yuehua\utils\loot\MyLootTable.java", "Java", 0, 38, 0, 13, 51
"d:\panling\yuehua-plugin\src\main\java\com\xiaoxiaoowo\yuehua\utils\loot\NumItem.java", "Java", 0, 10, 0, 4, 14
"d:\panling\yuehua-plugin\src\main\java\com\xiaoxiaoowo\yuehua\utils\loot\ProItem.java", "Java", 0, 10, 0, 4, 14
"d:\panling\yuehua-plugin\src\main\resources\plugin.yml", "YAML", 82, 0, 0, 1, 83
"Total", "-", 82, 84475, 3548, 14678, 102783