"filename", "language", "Java", "YAML", "comment", "blank", "total"
"d:\panling\yuehua-plugin\src\main\java\com\xiaoxiaoowo\yuehua\Yuehua.java", "Java", 383, 0, 28, 78, 489
"d:\panling\yuehua-plugin\src\main\java\com\xiaoxiaoowo\yuehua\commands\Test.java", "Java", 952, 0, 629, 315, 1896
"d:\panling\yuehua-plugin\src\main\java\com\xiaoxiaoowo\yuehua\commands\blockcommand\BlockTp.java", "Java", 43, 0, 0, 6, 49
"d:\panling\yuehua-plugin\src\main\java\com\xiaoxiaoowo\yuehua\commands\blockcommand\DuanZao.java", "Java", 145, 0, 0, 29, 174
"d:\panling\yuehua-plugin\src\main\java\com\xiaoxiaoowo\yuehua\commands\blockcommand\IntoGame.java", "Java", 120, 0, 12, 23, 155
"d:\panling\yuehua-plugin\src\main\java\com\xiaoxiaoowo\yuehua\commands\blockcommand\MarkRelife.java", "Java", 64, 0, 0, 8, 72
"d:\panling\yuehua-plugin\src\main\java\com\xiaoxiaoowo\yuehua\commands\blockcommand\MyBossSpawn.java", "Java", 38, 0, 0, 9, 47
"d:\panling\yuehua-plugin\src\main\java\com\xiaoxiaoowo\yuehua\commands\blockcommand\MySpawn.java", "Java", 39, 0, 0, 11, 50
"d:\panling\yuehua-plugin\src\main\java\com\xiaoxiaoowo\yuehua\commands\blockcommand\Relife.java", "Java", 123, 0, 1, 19, 143
"d:\panling\yuehua-plugin\src\main\java\com\xiaoxiaoowo\yuehua\commands\blockcommand\RenOu.java", "Java", 64, 0, 0, 10, 74
"d:\panling\yuehua-plugin\src\main\java\com\xiaoxiaoowo\yuehua\commands\blockcommand\RenOu2.java", "Java", 65, 0, 0, 8, 73
"d:\panling\yuehua-plugin\src\main\java\com\xiaoxiaoowo\yuehua\commands\blockcommand\Select.java", "Java", 166, 0, 1, 19, 186
"d:\panling\yuehua-plugin\src\main\java\com\xiaoxiaoowo\yuehua\commands\blockcommand\StoreRelifeStone.java", "Java", 58, 0, 0, 14, 72
"d:\panling\yuehua-plugin\src\main\java\com\xiaoxiaoowo\yuehua\commands\opcommand\Clearup.java", "Java", 67, 0, 0, 9, 76
"d:\panling\yuehua-plugin\src\main\java\com\xiaoxiaoowo\yuehua\commands\opcommand\GI.java", "Java", 642, 0, 134, 68, 844
"d:\panling\yuehua-plugin\src\main\java\com\xiaoxiaoowo\yuehua\commands\opcommand\MyTp.java", "Java", 97, 0, 0, 6, 103
"d:\panling\yuehua-plugin\src\main\java\com\xiaoxiaoowo\yuehua\commands\opcommand\MyTpTab.java", "Java", 26, 0, 0, 6, 32
"d:\panling\yuehua-plugin\src\main\java\com\xiaoxiaoowo\yuehua\commands\opcommand\PerGet.java", "Java", 55, 0, 0, 13, 68
"d:\panling\yuehua-plugin\src\main\java\com\xiaoxiaoowo\yuehua\commands\opcommand\SetSign.java", "Java", 45, 0, 0, 14, 59
"d:\panling\yuehua-plugin\src\main\java\com\xiaoxiaoowo\yuehua\commands\opcommand\Summon.java", "Java", 97, 0, 0, 5, 102
"d:\panling\yuehua-plugin\src\main\java\com\xiaoxiaoowo\yuehua\commands\opcommand\data\DataCountGet.java", "Java", 29, 0, 0, 5, 34
"d:\panling\yuehua-plugin\src\main\java\com\xiaoxiaoowo\yuehua\commands\opcommand\data\DataGet.java", "Java", 34, 0, 0, 5, 39
"d:\panling\yuehua-plugin\src\main\java\com\xiaoxiaoowo\yuehua\commands\opcommand\data\DataSet.java", "Java", 53, 0, 0, 23, 76
"d:\panling\yuehua-plugin\src\main\java\com\xiaoxiaoowo\yuehua\commands\opcommand\data\ItemDataGet.java", "Java", 43, 0, 0, 7, 50
"d:\panling\yuehua-plugin\src\main\java\com\xiaoxiaoowo\yuehua\commands\playercommand\ArrowCMD.java", "Java", 171, 0, 0, 28, 199
"d:\panling\yuehua-plugin\src\main\java\com\xiaoxiaoowo\yuehua\commands\playercommand\Buy.java", "Java", 77, 0, 0, 16, 93
"d:\panling\yuehua-plugin\src\main\java\com\xiaoxiaoowo\yuehua\commands\playercommand\Kill.java", "Java", 14, 0, 0, 3, 17
"d:\panling\yuehua-plugin\src\main\java\com\xiaoxiaoowo\yuehua\commands\playercommand\MoneyCMD.java", "Java", 416, 0, 2, 62, 480
"d:\panling\yuehua-plugin\src\main\java\com\xiaoxiaoowo\yuehua\commands\playercommand\Sale.java", "Java", 96, 0, 0, 20, 116
"d:\panling\yuehua-plugin\src\main\java\com\xiaoxiaoowo\yuehua\commands\playercommand\Sell.java", "Java", 149, 0, 1, 31, 181
"d:\panling\yuehua-plugin\src\main\java\com\xiaoxiaoowo\yuehua\commands\playercommand\Yh.java", "Java", 656, 0, 0, 66, 722
"d:\panling\yuehua-plugin\src\main\java\com\xiaoxiaoowo\yuehua\commands\playercommand\Yhteam.java", "Java", 294, 0, 0, 72, 366
"d:\panling\yuehua-plugin\src\main\java\com\xiaoxiaoowo\yuehua\commands\playercommand\YuanSuCMD.java", "Java", 1027, 0, 0, 26, 1053
"d:\panling\yuehua-plugin\src\main\java\com\xiaoxiaoowo\yuehua\commands\playercommand\completer\ArrowCom.java", "Java", 27, 0, 0, 7, 34
"d:\panling\yuehua-plugin\src\main\java\com\xiaoxiaoowo\yuehua\commands\playercommand\completer\BuyCom.java", "Java", 18, 0, 0, 4, 22
"d:\panling\yuehua-plugin\src\main\java\com\xiaoxiaoowo\yuehua\commands\playercommand\completer\MoneyCom.java", "Java", 41, 0, 0, 13, 54
"d:\panling\yuehua-plugin\src\main\java\com\xiaoxiaoowo\yuehua\commands\playercommand\completer\SaleCom.java", "Java", 21, 0, 0, 4, 25
"d:\panling\yuehua-plugin\src\main\java\com\xiaoxiaoowo\yuehua\commands\playercommand\completer\SellCom.java", "Java", 21, 0, 0, 4, 25
"d:\panling\yuehua-plugin\src\main\java\com\xiaoxiaoowo\yuehua\commands\playercommand\completer\Yhteam.java", "Java", 33, 0, 0, 9, 42
"d:\panling\yuehua-plugin\src\main\java\com\xiaoxiaoowo\yuehua\commands\playercommand\completer\YuanSuCom.java", "Java", 35, 0, 0, 8, 43
"d:\panling\yuehua-plugin\src\main\java\com\xiaoxiaoowo\yuehua\data\DanData.java", "Java", 112, 0, 1, 35, 148
"d:\panling\yuehua-plugin\src\main\java\com\xiaoxiaoowo\yuehua\data\Data.java", "Java", 503, 0, 8, 153, 664
"d:\panling\yuehua-plugin\src\main\java\com\xiaoxiaoowo\yuehua\data\GongData.java", "Java", 81, 0, 4, 30, 115
"d:\panling\yuehua-plugin\src\main\java\com\xiaoxiaoowo\yuehua\data\MonsterData.java", "Java", 71, 0, 0, 23, 94
"d:\panling\yuehua-plugin\src\main\java\com\xiaoxiaoowo\yuehua\data\PetData.java", "Java", 26, 0, 0, 4, 30
"d:\panling\yuehua-plugin\src\main\java\com\xiaoxiaoowo\yuehua\data\TransferData.java", "Java", 143, 0, 0, 56, 199
"d:\panling\yuehua-plugin\src\main\java\com\xiaoxiaoowo\yuehua\data\ZhanData.java", "Java", 29, 0, 1, 15, 45
"d:\panling\yuehua-plugin\src\main\java\com\xiaoxiaoowo\yuehua\data\slot\EnderChestSlot.java", "Java", 12, 0, 0, 4, 16
"d:\panling\yuehua-plugin\src\main\java\com\xiaoxiaoowo\yuehua\data\slot\Slot.java", "Java", 12, 0, 0, 9, 21
"d:\panling\yuehua-plugin\src\main\java\com\xiaoxiaoowo\yuehua\data\slot\SlotBuilder.java", "Java", 102, 0, 0, 29, 131
"d:\panling\yuehua-plugin\src\main\java\com\xiaoxiaoowo\yuehua\data\slot\SlotWithOneActiveSkill.java", "Java", 14, 0, 0, 8, 22
"d:\panling\yuehua-plugin\src\main\java\com\xiaoxiaoowo\yuehua\data\slot\SlotWithTwoActiveSkill.java", "Java", 17, 0, 0, 6, 23
"d:\panling\yuehua-plugin\src\main\java\com\xiaoxiaoowo\yuehua\display\test\TestDisplay.java", "Java", 6, 0, 0, 5, 11
"d:\panling\yuehua-plugin\src\main\java\com\xiaoxiaoowo\yuehua\display\test\TestRay.java", "Java", 31, 0, 5, 11, 47
"d:\panling\yuehua-plugin\src\main\java\com\xiaoxiaoowo\yuehua\display\utils\ParticleUtils.java", "Java", 12, 0, 0, 7, 19
"d:\panling\yuehua-plugin\src\main\java\com\xiaoxiaoowo\yuehua\entity\monster\Renou.java", "Java", 54, 0, 17, 17, 88
"d:\panling\yuehua-plugin\src\main\java\com\xiaoxiaoowo\yuehua\entity\monster\Renou2.java", "Java", 57, 0, 17, 17, 91
"d:\panling\yuehua-plugin\src\main\java\com\xiaoxiaoowo\yuehua\entity\monster\east\normal\EastNormalZombie.java", "Java", 50, 0, 16, 16, 82
"d:\panling\yuehua-plugin\src\main\java\com\xiaoxiaoowo\yuehua\entity\npc\dz\ArmorChest.java", "Java", 158, 0, 4, 32, 194
"d:\panling\yuehua-plugin\src\main\java\com\xiaoxiaoowo\yuehua\entity\npc\dz\ArmorFeet.java", "Java", 158, 0, 4, 32, 194
"d:\panling\yuehua-plugin\src\main\java\com\xiaoxiaoowo\yuehua\entity\npc\dz\ArmorHead.java", "Java", 159, 0, 4, 32, 195
"d:\panling\yuehua-plugin\src\main\java\com\xiaoxiaoowo\yuehua\entity\npc\dz\ArmorLeg.java", "Java", 158, 0, 4, 32, 194
"d:\panling\yuehua-plugin\src\main\java\com\xiaoxiaoowo\yuehua\entity\npc\dz\BiWeapon.java", "Java", 158, 0, 4, 26, 188
"d:\panling\yuehua-plugin\src\main\java\com\xiaoxiaoowo\yuehua\entity\npc\dz\DUShipin.java", "Java", 159, 0, 4, 26, 189
"d:\panling\yuehua-plugin\src\main\java\com\xiaoxiaoowo\yuehua\entity\npc\dz\DanWeapon.java", "Java", 86, 0, 4, 21, 111
"d:\panling\yuehua-plugin\src\main\java\com\xiaoxiaoowo\yuehua\entity\npc\dz\Fabao1.java", "Java", 119, 0, 4, 24, 147
"d:\panling\yuehua-plugin\src\main\java\com\xiaoxiaoowo\yuehua\entity\npc\dz\Fabao2.java", "Java", 119, 0, 4, 24, 147
"d:\panling\yuehua-plugin\src\main\java\com\xiaoxiaoowo\yuehua\entity\npc\dz\Fabao3.java", "Java", 119, 0, 4, 24, 147
"d:\panling\yuehua-plugin\src\main\java\com\xiaoxiaoowo\yuehua\entity\npc\dz\GongWeapon.java", "Java", 158, 0, 4, 26, 188
"d:\panling\yuehua-plugin\src\main\java\com\xiaoxiaoowo\yuehua\entity\npc\dz\MIAOFAGE.java", "Java", 40, 0, 4, 11, 55
"d:\panling\yuehua-plugin\src\main\java\com\xiaoxiaoowo\yuehua\entity\npc\dz\MINGZHUTANG.java", "Java", 40, 0, 4, 11, 55
"d:\panling\yuehua-plugin\src\main\java\com\xiaoxiaoowo\yuehua\entity\npc\dz\TIEJIANGPU.java", "Java", 40, 0, 4, 11, 55
"d:\panling\yuehua-plugin\src\main\java\com\xiaoxiaoowo\yuehua\entity\npc\dz\XUESHIPIN.java", "Java", 129, 0, 4, 25, 158
"d:\panling\yuehua-plugin\src\main\java\com\xiaoxiaoowo\yuehua\entity\npc\dz\YIBAOLOU.java", "Java", 40, 0, 4, 11, 55
"d:\panling\yuehua-plugin\src\main\java\com\xiaoxiaoowo\yuehua\entity\npc\dz\Yiqi.java", "Java", 158, 0, 4, 26, 188
"d:\panling\yuehua-plugin\src\main\java\com\xiaoxiaoowo\yuehua\entity\npc\dz\Ys1.java", "Java", 123, 0, 4, 24, 151
"d:\panling\yuehua-plugin\src\main\java\com\xiaoxiaoowo\yuehua\entity\npc\dz\Ys2.java", "Java", 121, 0, 4, 24, 149
"d:\panling\yuehua-plugin\src\main\java\com\xiaoxiaoowo\yuehua\entity\npc\dz\Ys3.java", "Java", 121, 0, 4, 24, 149
"d:\panling\yuehua-plugin\src\main\java\com\xiaoxiaoowo\yuehua\entity\npc\dz\ZhanWeapon.java", "Java", 158, 0, 4, 26, 188
"d:\panling\yuehua-plugin\src\main\java\com\xiaoxiaoowo\yuehua\entity\npc\food\HAIXIANFAN.java", "Java", 89, 0, 4, 23, 116
"d:\panling\yuehua-plugin\src\main\java\com\xiaoxiaoowo\yuehua\entity\npc\food\HUNCAIFAN.java", "Java", 89, 0, 4, 23, 116
"d:\panling\yuehua-plugin\src\main\java\com\xiaoxiaoowo\yuehua\entity\npc\food\SHUIGUOFAN.java", "Java", 116, 0, 4, 25, 145
"d:\panling\yuehua-plugin\src\main\java\com\xiaoxiaoowo\yuehua\entity\npc\food\SUSHIFAN.java", "Java", 89, 0, 4, 23, 116
"d:\panling\yuehua-plugin\src\main\java\com\xiaoxiaoowo\yuehua\entity\npc\fulin\FuLingTaiYi.java", "Java", 41, 0, 4, 11, 56
"d:\panling\yuehua-plugin\src\main\java\com\xiaoxiaoowo\yuehua\entity\npc\fulin\KEHUASHI1.java", "Java", 126, 0, 4, 12, 142
"d:\panling\yuehua-plugin\src\main\java\com\xiaoxiaoowo\yuehua\entity\npc\fulin\KEHUASHI2.java", "Java", 126, 0, 4, 12, 142
"d:\panling\yuehua-plugin\src\main\java\com\xiaoxiaoowo\yuehua\entity\npc\fulin\KEHUASHI3.java", "Java", 126, 0, 4, 12, 142
"d:\panling\yuehua-plugin\src\main\java\com\xiaoxiaoowo\yuehua\entity\npc\middle\BUMINSHI.java", "Java", 51, 0, 4, 14, 69
"d:\panling\yuehua-plugin\src\main\java\com\xiaoxiaoowo\yuehua\entity\npc\middle\QianZhuang.java", "Java", 86, 0, 4, 17, 107
"d:\panling\yuehua-plugin\src\main\java\com\xiaoxiaoowo\yuehua\entity\npc\middle\ZAHUO.java", "Java", 94, 0, 4, 20, 118
"d:\panling\yuehua-plugin\src\main\java\com\xiaoxiaoowo\yuehua\entity\npc\middle\ZHINV.java", "Java", 91, 0, 4, 23, 118
"d:\panling\yuehua-plugin\src\main\java\com\xiaoxiaoowo\yuehua\entity\npc\yushi\Bingshuangshi.java", "Java", 117, 0, 4, 27, 148
"d:\panling\yuehua-plugin\src\main\java\com\xiaoxiaoowo\yuehua\entity\npc\yushi\Cuilvshi.java", "Java", 116, 0, 4, 27, 147
"d:\panling\yuehua-plugin\src\main\java\com\xiaoxiaoowo\yuehua\entity\npc\yushi\Dianlanshi.java", "Java", 116, 0, 4, 27, 147
"d:\panling\yuehua-plugin\src\main\java\com\xiaoxiaoowo\yuehua\entity\npc\yushi\Hongyueshi.java", "Java", 116, 0, 4, 27, 147
"d:\panling\yuehua-plugin\src\main\java\com\xiaoxiaoowo\yuehua\entity\npc\yushi\Houtushi.java", "Java", 116, 0, 4, 27, 147
"d:\panling\yuehua-plugin\src\main\java\com\xiaoxiaoowo\yuehua\entity\npc\yushi\Jinhuangshi.java", "Java", 116, 0, 4, 27, 147
"d:\panling\yuehua-plugin\src\main\java\com\xiaoxiaoowo\yuehua\entity\npc\yushi\Miyinshi.java", "Java", 116, 0, 4, 27, 147
"d:\panling\yuehua-plugin\src\main\java\com\xiaoxiaoowo\yuehua\entity\npc\yushi\Suiyanshi.java", "Java", 116, 0, 4, 27, 147
"d:\panling\yuehua-plugin\src\main\java\com\xiaoxiaoowo\yuehua\entity\npc\yushi\Tulushi.java", "Java", 116, 0, 4, 27, 147
"d:\panling\yuehua-plugin\src\main\java\com\xiaoxiaoowo\yuehua\entity\npc\yushi\Xueseshi.java", "Java", 116, 0, 4, 27, 147
"d:\panling\yuehua-plugin\src\main\java\com\xiaoxiaoowo\yuehua\entity\npc\yushi\Yanyangshi.java", "Java", 116, 0, 4, 27, 147
"d:\panling\yuehua-plugin\src\main\java\com\xiaoxiaoowo\yuehua\entity\npc\yushi\Yaochijinmu.java", "Java", 41, 0, 4, 19, 64
"d:\panling\yuehua-plugin\src\main\java\com\xiaoxiaoowo\yuehua\entity\npc\yushi\Yulushi.java", "Java", 116, 0, 4, 27, 147
"d:\panling\yuehua-plugin\src\main\java\com\xiaoxiaoowo\yuehua\entity\npc\yushi\Zijinshi.java", "Java", 116, 0, 4, 27, 147
"d:\panling\yuehua-plugin\src\main\java\com\xiaoxiaoowo\yuehua\entity\other\Pig.java", "Java", 18, 0, 5, 4, 27
"d:\panling\yuehua-plugin\src\main\java\com\xiaoxiaoowo\yuehua\event\Inventory\Click.java", "Java", 1561, 0, 27, 148, 1736
"d:\panling\yuehua-plugin\src\main\java\com\xiaoxiaoowo\yuehua\event\Inventory\Close.java", "Java", 137, 0, 0, 12, 149
"d:\panling\yuehua-plugin\src\main\java\com\xiaoxiaoowo\yuehua\event\Inventory\Open.java", "Java", 18, 0, 0, 4, 22
"d:\panling\yuehua-plugin\src\main\java\com\xiaoxiaoowo\yuehua\event\Projectile\Hit.java", "Java", 36, 0, 1, 8, 45
"d:\panling\yuehua-plugin\src\main\java\com\xiaoxiaoowo\yuehua\event\Projectile\Launch.java", "Java", 57, 0, 0, 13, 70
"d:\panling\yuehua-plugin\src\main\java\com\xiaoxiaoowo\yuehua\event\Spawner\Spawn.java", "Java", 17, 0, 3, 8, 28
"d:\panling\yuehua-plugin\src\main\java\com\xiaoxiaoowo\yuehua\event\entity\AddToWorld.java", "Java", 25, 0, 0, 7, 32
"d:\panling\yuehua-plugin\src\main\java\com\xiaoxiaoowo\yuehua\event\entity\Breed.java", "Java", 10, 0, 0, 4, 14
"d:\panling\yuehua-plugin\src\main\java\com\xiaoxiaoowo\yuehua\event\entity\Damage.java", "Java", 74, 0, 2, 25, 101
"d:\panling\yuehua-plugin\src\main\java\com\xiaoxiaoowo\yuehua\event\entity\DamageByEntity.java", "Java", 417, 0, 20, 111, 548
"d:\panling\yuehua-plugin\src\main\java\com\xiaoxiaoowo\yuehua\event\entity\Death.java", "Java", 28, 0, 1, 6, 35
"d:\panling\yuehua-plugin\src\main\java\com\xiaoxiaoowo\yuehua\event\entity\LoadCrossBow.java", "Java", 35, 0, 1, 7, 43
"d:\panling\yuehua-plugin\src\main\java\com\xiaoxiaoowo\yuehua\event\entity\PotionSpLash.java", "Java", 32, 0, 0, 5, 37
"d:\panling\yuehua-plugin\src\main\java\com\xiaoxiaoowo\yuehua\event\entity\RegainHealth.java", "Java", 31, 0, 0, 4, 35
"d:\panling\yuehua-plugin\src\main\java\com\xiaoxiaoowo\yuehua\event\entity\RemoveFromWorld.java", "Java", 30, 0, 0, 7, 37
"d:\panling\yuehua-plugin\src\main\java\com\xiaoxiaoowo\yuehua\event\entity\ShootBow.java", "Java", 78, 0, 4, 28, 110
"d:\panling\yuehua-plugin\src\main\java\com\xiaoxiaoowo\yuehua\event\entity\SlimeSpilt.java", "Java", 10, 0, 0, 3, 13
"d:\panling\yuehua-plugin\src\main\java\com\xiaoxiaoowo\yuehua\event\entity\Transform.java", "Java", 10, 0, 0, 4, 14
"d:\panling\yuehua-plugin\src\main\java\com\xiaoxiaoowo\yuehua\event\player\ConsumeItem.java", "Java", 27, 0, 4, 16, 47
"d:\panling\yuehua-plugin\src\main\java\com\xiaoxiaoowo\yuehua\event\player\Death.java", "Java", 25, 0, 69, 13, 107
"d:\panling\yuehua-plugin\src\main\java\com\xiaoxiaoowo\yuehua\event\player\DropItem.java", "Java", 17, 0, 0, 4, 21
"d:\panling\yuehua-plugin\src\main\java\com\xiaoxiaoowo\yuehua\event\player\FlowerPotManipulate.java", "Java", 17, 0, 0, 4, 21
"d:\panling\yuehua-plugin\src\main\java\com\xiaoxiaoowo\yuehua\event\player\Interact.java", "Java", 382, 0, 11, 32, 425
"d:\panling\yuehua-plugin\src\main\java\com\xiaoxiaoowo\yuehua\event\player\InventorySlotChange.java", "Java", 684, 0, 112, 53, 849
"d:\panling\yuehua-plugin\src\main\java\com\xiaoxiaoowo\yuehua\event\player\Join.java", "Java", 208, 0, 7, 40, 255
"d:\panling\yuehua-plugin\src\main\java\com\xiaoxiaoowo\yuehua\event\player\LevelChange.java", "Java", 170, 0, 5, 19, 194
"d:\panling\yuehua-plugin\src\main\java\com\xiaoxiaoowo\yuehua\event\player\Login.java", "Java", 23, 0, 0, 7, 30
"d:\panling\yuehua-plugin\src\main\java\com\xiaoxiaoowo\yuehua\event\player\Quit.java", "Java", 80, 0, 0, 11, 91
"d:\panling\yuehua-plugin\src\main\java\com\xiaoxiaoowo\yuehua\event\player\Swap.java", "Java", 14, 0, 0, 3, 17
"d:\panling\yuehua-plugin\src\main\java\com\xiaoxiaoowo\yuehua\event\player\Teleport.java", "Java", 13, 0, 0, 4, 17
"d:\panling\yuehua-plugin\src\main\java\com\xiaoxiaoowo\yuehua\itemstack\Book.java", "Java", 280, 0, 0, 39, 319
"d:\panling\yuehua-plugin\src\main\java\com\xiaoxiaoowo\yuehua\itemstack\dz\Core.java", "Java", 3959, 0, 61, 703, 4723
"d:\panling\yuehua-plugin\src\main\java\com\xiaoxiaoowo\yuehua\itemstack\dz\FuLing.java", "Java", 862, 0, 13, 89, 964
"d:\panling\yuehua-plugin\src\main\java\com\xiaoxiaoowo\yuehua\itemstack\dz\Ingredient.java", "Java", 705, 0, 16, 72, 793
"d:\panling\yuehua-plugin\src\main\java\com\xiaoxiaoowo\yuehua\itemstack\dz\TehuaShui.java", "Java", 316, 0, 0, 82, 398
"d:\panling\yuehua-plugin\src\main\java\com\xiaoxiaoowo\yuehua\itemstack\dz\YuShi.java", "Java", 1575, 0, 13, 173, 1761
"d:\panling\yuehua-plugin\src\main\java\com\xiaoxiaoowo\yuehua\itemstack\dz\YuanSu.java", "Java", 213, 0, 4, 31, 248
"d:\panling\yuehua-plugin\src\main\java\com\xiaoxiaoowo\yuehua\itemstack\liandan\Dan.java", "Java", 78, 0, 1, 19, 98
"d:\panling\yuehua-plugin\src\main\java\com\xiaoxiaoowo\yuehua\itemstack\liandan\Herb.java", "Java", 196, 0, 4, 24, 224
"d:\panling\yuehua-plugin\src\main\java\com\xiaoxiaoowo\yuehua\itemstack\monsterzhuangbei\Boot.java", "Java", 177, 0, 0, 30, 207
"d:\panling\yuehua-plugin\src\main\java\com\xiaoxiaoowo\yuehua\itemstack\monsterzhuangbei\Bow.java", "Java", 71, 0, 0, 19, 90
"d:\panling\yuehua-plugin\src\main\java\com\xiaoxiaoowo\yuehua\itemstack\monsterzhuangbei\Chest.java", "Java", 177, 0, 0, 31, 208
"d:\panling\yuehua-plugin\src\main\java\com\xiaoxiaoowo\yuehua\itemstack\monsterzhuangbei\Helmet.java", "Java", 109, 0, 0, 27, 136
"d:\panling\yuehua-plugin\src\main\java\com\xiaoxiaoowo\yuehua\itemstack\monsterzhuangbei\Leg.java", "Java", 93, 0, 0, 29, 122
"d:\panling\yuehua-plugin\src\main\java\com\xiaoxiaoowo\yuehua\itemstack\monsterzhuangbei\Weapon.java", "Java", 469, 0, 20, 144, 633
"d:\panling\yuehua-plugin\src\main\java\com\xiaoxiaoowo\yuehua\itemstack\other\Collection.java", "Java", 157, 0, 0, 28, 185
"d:\panling\yuehua-plugin\src\main\java\com\xiaoxiaoowo\yuehua\itemstack\other\Feather.java", "Java", 225, 0, 0, 26, 251
"d:\panling\yuehua-plugin\src\main\java\com\xiaoxiaoowo\yuehua\itemstack\other\Food.java", "Java", 642, 0, 7, 63, 712
"d:\panling\yuehua-plugin\src\main\java\com\xiaoxiaoowo\yuehua\itemstack\other\FuBen.java", "Java", 140, 0, 2, 17, 159
"d:\panling\yuehua-plugin\src\main\java\com\xiaoxiaoowo\yuehua\itemstack\other\Money.java", "Java", 94, 0, 0, 22, 116
"d:\panling\yuehua-plugin\src\main\java\com\xiaoxiaoowo\yuehua\itemstack\other\MoneyLoot.java", "Java", 202, 0, 6, 55, 263
"d:\panling\yuehua-plugin\src\main\java\com\xiaoxiaoowo\yuehua\itemstack\other\Other.java", "Java", 47, 0, 0, 13, 60
"d:\panling\yuehua-plugin\src\main\java\com\xiaoxiaoowo\yuehua\itemstack\other\RaceProvince.java", "Java", 86, 0, 0, 25, 111
"d:\panling\yuehua-plugin\src\main\java\com\xiaoxiaoowo\yuehua\itemstack\other\XP.java", "Java", 105, 0, 1, 21, 127
"d:\panling\yuehua-plugin\src\main\java\com\xiaoxiaoowo\yuehua\itemstack\zhuangbei\ArmorChest.java", "Java", 626, 0, 4, 28, 658
"d:\panling\yuehua-plugin\src\main\java\com\xiaoxiaoowo\yuehua\itemstack\zhuangbei\ArmorFeet.java", "Java", 617, 0, 4, 28, 649
"d:\panling\yuehua-plugin\src\main\java\com\xiaoxiaoowo\yuehua\itemstack\zhuangbei\ArmorHead.java", "Java", 626, 0, 4, 57, 687
"d:\panling\yuehua-plugin\src\main\java\com\xiaoxiaoowo\yuehua\itemstack\zhuangbei\ArmorLeg.java", "Java", 626, 0, 4, 32, 662
"d:\panling\yuehua-plugin\src\main\java\com\xiaoxiaoowo\yuehua\itemstack\zhuangbei\BiWeapon.java", "Java", 360, 0, 3, 50, 413
"d:\panling\yuehua-plugin\src\main\java\com\xiaoxiaoowo\yuehua\itemstack\zhuangbei\Fabao.java", "Java", 986, 0, 12, 88, 1086
"d:\panling\yuehua-plugin\src\main\java\com\xiaoxiaoowo\yuehua\itemstack\zhuangbei\Shipin.java", "Java", 1206, 0, 0, 156, 1362
"d:\panling\yuehua-plugin\src\main\java\com\xiaoxiaoowo\yuehua\itemstack\zhuangbei\Weapon.java", "Java", 743, 0, 10, 65, 818
"d:\panling\yuehua-plugin\src\main\java\com\xiaoxiaoowo\yuehua\itemstack\zhuangbei\YiQi.java", "Java", 360, 0, 3, 49, 412
"d:\panling\yuehua-plugin\src\main\java\com\xiaoxiaoowo\yuehua\shilian\huancheng\HuanCheng.java", "Java", 77, 0, 1, 20, 98
"d:\panling\yuehua-plugin\src\main\java\com\xiaoxiaoowo\yuehua\system\Act.java", "Java", 417, 0, 1, 100, 518
"d:\panling\yuehua-plugin\src\main\java\com\xiaoxiaoowo\yuehua\system\DataContainer.java", "Java", 186, 0, 18, 57, 261
"d:\panling\yuehua-plugin\src\main\java\com\xiaoxiaoowo\yuehua\system\DoJiNeng.java", "Java", 44, 0, 0, 19, 63
"d:\panling\yuehua-plugin\src\main\java\com\xiaoxiaoowo\yuehua\system\Team.java", "Java", 44, 0, 1, 9, 54
"d:\panling\yuehua-plugin\src\main\java\com\xiaoxiaoowo\yuehua\system\act\ActBiWeapon.java", "Java", 3, 0, 0, 2, 5
"d:\panling\yuehua-plugin\src\main\java\com\xiaoxiaoowo\yuehua\system\act\ActFabao.java", "Java", 3, 0, 0, 2, 5
"d:\panling\yuehua-plugin\src\main\java\com\xiaoxiaoowo\yuehua\system\act\ActFuling.java", "Java", 838, 0, 0, 106, 944
"d:\panling\yuehua-plugin\src\main\java\com\xiaoxiaoowo\yuehua\system\act\ActHujia.java", "Java", 166, 0, 6, 48, 220
"d:\panling\yuehua-plugin\src\main\java\com\xiaoxiaoowo\yuehua\system\act\ActShipin.java", "Java", 3, 0, 0, 2, 5
"d:\panling\yuehua-plugin\src\main\java\com\xiaoxiaoowo\yuehua\system\act\ActWeapon.java", "Java", 3, 0, 0, 2, 5
"d:\panling\yuehua-plugin\src\main\java\com\xiaoxiaoowo\yuehua\system\act\ActYiqi.java", "Java", 3, 0, 0, 2, 5
"d:\panling\yuehua-plugin\src\main\java\com\xiaoxiaoowo\yuehua\system\act\ActYuShi.java", "Java", 1660, 0, 0, 236, 1896
"d:\panling\yuehua-plugin\src\main\java\com\xiaoxiaoowo\yuehua\system\dz\Fabao.java", "Java", 17, 0, 0, 7, 24
"d:\panling\yuehua-plugin\src\main\java\com\xiaoxiaoowo\yuehua\system\dz\LianDan.java", "Java", 29, 0, 0, 8, 37
"d:\panling\yuehua-plugin\src\main\java\com\xiaoxiaoowo\yuehua\system\dz\Shipin.java", "Java", 17, 0, 0, 5, 22
"d:\panling\yuehua-plugin\src\main\java\com\xiaoxiaoowo\yuehua\system\dz\TieJiangPu.java", "Java", 17, 0, 0, 6, 23
"d:\panling\yuehua-plugin\src\main\java\com\xiaoxiaoowo\yuehua\system\dz\Yiqi.java", "Java", 17, 0, 0, 5, 22
"d:\panling\yuehua-plugin\src\main\java\com\xiaoxiaoowo\yuehua\system\handleMonsters\DoMonsterAttack.java", "Java", 18, 0, 0, 4, 22
"d:\panling\yuehua-plugin\src\main\java\com\xiaoxiaoowo\yuehua\system\handleMonsters\DoMonsterAttackedObserver.java", "Java", 12, 0, 0, 4, 16
"d:\panling\yuehua-plugin\src\main\java\com\xiaoxiaoowo\yuehua\system\handleObsevers\DoAttackObserver.java", "Java", 12, 0, 0, 3, 15
"d:\panling\yuehua-plugin\src\main\java\com\xiaoxiaoowo\yuehua\system\handleObsevers\DoAttackedObserver.java", "Java", 41, 0, 0, 6, 47
"d:\panling\yuehua-plugin\src\main\java\com\xiaoxiaoowo\yuehua\system\handleObsevers\DoBaojiObserver.java", "Java", 12, 0, 0, 4, 16
"d:\panling\yuehua-plugin\src\main\java\com\xiaoxiaoowo\yuehua\system\handleObsevers\DoCuredObserver.java", "Java", 25, 0, 0, 6, 31
"d:\panling\yuehua-plugin\src\main\java\com\xiaoxiaoowo\yuehua\system\handleObsevers\DoHitObserver.java", "Java", 12, 0, 0, 4, 16
"d:\panling\yuehua-plugin\src\main\java\com\xiaoxiaoowo\yuehua\system\handleObsevers\DoHuDunObserver.java", "Java", 8, 0, 0, 4, 12
"d:\panling\yuehua-plugin\src\main\java\com\xiaoxiaoowo\yuehua\system\handleObsevers\DoJiNengObservers.java", "Java", 8, 0, 0, 3, 11
"d:\panling\yuehua-plugin\src\main\java\com\xiaoxiaoowo\yuehua\system\handleObsevers\DoPlayerProjectile.java", "Java", 14, 0, 0, 5, 19
"d:\panling\yuehua-plugin\src\main\java\com\xiaoxiaoowo\yuehua\system\handleObsevers\DoZhenfaObserver.java", "Java", 8, 0, 0, 3, 11
"d:\panling\yuehua-plugin\src\main\java\com\xiaoxiaoowo\yuehua\task\hujia\Xiong1.java", "Java", 34, 0, 0, 8, 42
"d:\panling\yuehua-plugin\src\main\java\com\xiaoxiaoowo\yuehua\task\other\SaleTask.java", "Java", 105, 0, 1, 16, 122
"d:\panling\yuehua-plugin\src\main\java\com\xiaoxiaoowo\yuehua\utils\Check.java", "Java", 50, 0, 0, 13, 63
"d:\panling\yuehua-plugin\src\main\java\com\xiaoxiaoowo\yuehua\utils\ComponentSet.java", "Java", 37, 0, 0, 14, 51
"d:\panling\yuehua-plugin\src\main\java\com\xiaoxiaoowo\yuehua\utils\Cure.java", "Java", 77, 0, 4, 20, 101
"d:\panling\yuehua-plugin\src\main\java\com\xiaoxiaoowo\yuehua\utils\Damage.java", "Java", 103, 0, 12, 40, 155
"d:\panling\yuehua-plugin\src\main\java\com\xiaoxiaoowo\yuehua\utils\GetEntity.java", "Java", 8059, 0, 925, 695, 9679
"d:\panling\yuehua-plugin\src\main\java\com\xiaoxiaoowo\yuehua\utils\LocationCheck.java", "Java", 154, 0, 0, 17, 171
"d:\panling\yuehua-plugin\src\main\java\com\xiaoxiaoowo\yuehua\utils\LocationSet.java", "Java", 84, 0, 1, 4, 89
"d:\panling\yuehua-plugin\src\main\java\com\xiaoxiaoowo\yuehua\utils\MoveEntity.java", "Java", 34, 0, 14, 22, 70
"d:\panling\yuehua-plugin\src\main\java\com\xiaoxiaoowo\yuehua\utils\MySocket.java", "Java", 98, 0, 0, 16, 114
"d:\panling\yuehua-plugin\src\main\java\com\xiaoxiaoowo\yuehua\utils\PlaySound.java", "Java", 93, 0, 0, 34, 127
"d:\panling\yuehua-plugin\src\main\java\com\xiaoxiaoowo\yuehua\utils\SQL.java", "Java", 1330, 0, 33, 231, 1594
"d:\panling\yuehua-plugin\src\main\java\com\xiaoxiaoowo\yuehua\utils\TcpServer.java", "Java", 59, 0, 8, 12, 79
"d:\panling\yuehua-plugin\src\main\java\com\xiaoxiaoowo\yuehua\utils\ZeroAttributeModifier.java", "Java", 33, 0, 0, 9, 42
"d:\panling\yuehua-plugin\src\main\resources\plugin.yml", "YAML", 0, 82, 0, 1, 83
"Total", "-", 48547, 82, 2554, 7388, 58571