"filename", "language", "YAML", "Java", "Markdown", "JSON", "comment", "blank", "total"
"d:\panling\yuehua-plugin\src\.VSCodeCounter\2024-10-18_14-33-33\details.md", "Markdown", 0, 0, 223, 0, 0, 6, 229
"d:\panling\yuehua-plugin\src\.VSCodeCounter\2024-10-18_14-33-33\diff-details.md", "Markdown", 0, 0, 9, 0, 0, 6, 15
"d:\panling\yuehua-plugin\src\.VSCodeCounter\2024-10-18_14-33-33\diff.md", "Markdown", 0, 0, 12, 0, 0, 7, 19
"d:\panling\yuehua-plugin\src\.VSCodeCounter\2024-10-18_14-33-33\results.json", "JSON", 0, 0, 0, 1, 0, 0, 1
"d:\panling\yuehua-plugin\src\.VSCodeCounter\2024-10-18_14-33-33\results.md", "Markdown", 0, 0, 73, 0, 0, 7, 80
"d:\panling\yuehua-plugin\src\main\java\com\xiaoxiaoowo\yuehua\Yuehua.java", "Java", 0, 266, 0, 0, 29, 49, 344
"d:\panling\yuehua-plugin\src\main\java\com\xiaoxiaoowo\yuehua\attribute\AttributeSet.java", "Java", 0, 11, 0, 0, 0, 7, 18
"d:\panling\yuehua-plugin\src\main\java\com\xiaoxiaoowo\yuehua\attribute\attributes\MyAttribute.java", "Java", 0, 7, 0, 0, 0, 6, 13
"d:\panling\yuehua-plugin\src\main\java\com\xiaoxiaoowo\yuehua\attribute\attributes\fangyu\Fakang.java", "Java", 0, 26, 0, 0, 0, 6, 32
"d:\panling\yuehua-plugin\src\main\java\com\xiaoxiaoowo\yuehua\attribute\attributes\fangyu\Gedang.java", "Java", 0, 26, 0, 0, 0, 6, 32
"d:\panling\yuehua-plugin\src\main\java\com\xiaoxiaoowo\yuehua\attribute\attributes\fangyu\Hujia.java", "Java", 0, 26, 0, 0, 0, 6, 32
"d:\panling\yuehua-plugin\src\main\java\com\xiaoxiaoowo\yuehua\attribute\attributes\fangyu\Renxing.java", "Java", 0, 26, 0, 0, 0, 6, 32
"d:\panling\yuehua-plugin\src\main\java\com\xiaoxiaoowo\yuehua\attribute\attributes\fangyu\Shengji.java", "Java", 0, 26, 0, 0, 0, 6, 32
"d:\panling\yuehua-plugin\src\main\java\com\xiaoxiaoowo\yuehua\attribute\attributes\fangyu\ShouHu.java", "Java", 0, 26, 0, 0, 0, 6, 32
"d:\panling\yuehua-plugin\src\main\java\com\xiaoxiaoowo\yuehua\attribute\attributes\jingong\ArrowAdd.java", "Java", 0, 35, 0, 0, 0, 13, 48
"d:\panling\yuehua-plugin\src\main\java\com\xiaoxiaoowo\yuehua\attribute\attributes\jingong\ArrowMul.java", "Java", 0, 35, 0, 0, 0, 12, 47
"d:\panling\yuehua-plugin\src\main\java\com\xiaoxiaoowo\yuehua\attribute\attributes\jingong\AttackAdd.java", "Java", 0, 32, 0, 0, 0, 13, 45
"d:\panling\yuehua-plugin\src\main\java\com\xiaoxiaoowo\yuehua\attribute\attributes\jingong\AttackMul.java", "Java", 0, 32, 0, 0, 0, 12, 44
"d:\panling\yuehua-plugin\src\main\java\com\xiaoxiaoowo\yuehua\attribute\attributes\jingong\BaoJi.java", "Java", 0, 26, 0, 0, 0, 6, 32
"d:\panling\yuehua-plugin\src\main\java\com\xiaoxiaoowo\yuehua\attribute\attributes\jingong\BaojiXiaoguo.java", "Java", 0, 26, 0, 0, 0, 6, 32
"d:\panling\yuehua-plugin\src\main\java\com\xiaoxiaoowo\yuehua\attribute\attributes\jingong\CoolReduce.java", "Java", 0, 26, 0, 0, 0, 6, 32
"d:\panling\yuehua-plugin\src\main\java\com\xiaoxiaoowo\yuehua\attribute\attributes\jingong\CoolReduceUnlimited.java", "Java", 0, 26, 0, 0, 0, 6, 32
"d:\panling\yuehua-plugin\src\main\java\com\xiaoxiaoowo\yuehua\attribute\attributes\jingong\Pofa.java", "Java", 0, 26, 0, 0, 0, 6, 32
"d:\panling\yuehua-plugin\src\main\java\com\xiaoxiaoowo\yuehua\attribute\attributes\jingong\Pojia.java", "Java", 0, 26, 0, 0, 0, 6, 32
"d:\panling\yuehua-plugin\src\main\java\com\xiaoxiaoowo\yuehua\attribute\attributes\jingong\ZhenfaAdd.java", "Java", 0, 37, 0, 0, 0, 13, 50
"d:\panling\yuehua-plugin\src\main\java\com\xiaoxiaoowo\yuehua\attribute\attributes\jingong\ZhenfaMul.java", "Java", 0, 32, 0, 0, 0, 12, 44
"d:\panling\yuehua-plugin\src\main\java\com\xiaoxiaoowo\yuehua\attribute\attributes\special\ArrowCountMax.java", "Java", 0, 26, 0, 0, 0, 6, 32
"d:\panling\yuehua-plugin\src\main\java\com\xiaoxiaoowo\yuehua\attribute\attributes\special\Danlu.java", "Java", 0, 38, 0, 0, 0, 7, 45
"d:\panling\yuehua-plugin\src\main\java\com\xiaoxiaoowo\yuehua\attribute\attributes\special\IsBow.java", "Java", 0, 21, 0, 0, 0, 4, 25
"d:\panling\yuehua-plugin\src\main\java\com\xiaoxiaoowo\yuehua\attribute\attributes\vanilla\AttackRange.java", "Java", 0, 27, 0, 0, 0, 6, 33
"d:\panling\yuehua-plugin\src\main\java\com\xiaoxiaoowo\yuehua\attribute\attributes\vanilla\AttackSpeed.java", "Java", 0, 27, 0, 0, 0, 6, 33
"d:\panling\yuehua-plugin\src\main\java\com\xiaoxiaoowo\yuehua\attribute\attributes\vanilla\DingLi.java", "Java", 0, 28, 0, 0, 0, 7, 35
"d:\panling\yuehua-plugin\src\main\java\com\xiaoxiaoowo\yuehua\attribute\attributes\vanilla\Hp.java", "Java", 0, 27, 0, 0, 0, 6, 33
"d:\panling\yuehua-plugin\src\main\java\com\xiaoxiaoowo\yuehua\attribute\attributes\vanilla\Jump.java", "Java", 0, 27, 0, 0, 0, 7, 34
"d:\panling\yuehua-plugin\src\main\java\com\xiaoxiaoowo\yuehua\attribute\attributes\vanilla\Speed.java", "Java", 0, 43, 0, 0, 0, 9, 52
"d:\panling\yuehua-plugin\src\main\java\com\xiaoxiaoowo\yuehua\commands\Test.java", "Java", 0, 992, 0, 0, 659, 323, 1974
"d:\panling\yuehua-plugin\src\main\java\com\xiaoxiaoowo\yuehua\commands\blockcommand\BlockTp.java", "Java", 0, 42, 0, 0, 0, 6, 48
"d:\panling\yuehua-plugin\src\main\java\com\xiaoxiaoowo\yuehua\commands\blockcommand\IntoGame.java", "Java", 0, 129, 0, 0, 12, 23, 164
"d:\panling\yuehua-plugin\src\main\java\com\xiaoxiaoowo\yuehua\commands\blockcommand\MarkRelife.java", "Java", 0, 64, 0, 0, 0, 8, 72
"d:\panling\yuehua-plugin\src\main\java\com\xiaoxiaoowo\yuehua\commands\blockcommand\MyBossSpawn.java", "Java", 0, 38, 0, 0, 0, 9, 47
"d:\panling\yuehua-plugin\src\main\java\com\xiaoxiaoowo\yuehua\commands\blockcommand\MySpawn.java", "Java", 0, 39, 0, 0, 0, 11, 50
"d:\panling\yuehua-plugin\src\main\java\com\xiaoxiaoowo\yuehua\commands\blockcommand\Relife.java", "Java", 0, 123, 0, 0, 1, 19, 143
"d:\panling\yuehua-plugin\src\main\java\com\xiaoxiaoowo\yuehua\commands\blockcommand\RenOu.java", "Java", 0, 64, 0, 0, 0, 10, 74
"d:\panling\yuehua-plugin\src\main\java\com\xiaoxiaoowo\yuehua\commands\blockcommand\RenOu2.java", "Java", 0, 65, 0, 0, 0, 8, 73
"d:\panling\yuehua-plugin\src\main\java\com\xiaoxiaoowo\yuehua\commands\blockcommand\Select.java", "Java", 0, 166, 0, 0, 1, 19, 186
"d:\panling\yuehua-plugin\src\main\java\com\xiaoxiaoowo\yuehua\commands\blockcommand\StoreRelifeStone.java", "Java", 0, 58, 0, 0, 0, 14, 72
"d:\panling\yuehua-plugin\src\main\java\com\xiaoxiaoowo\yuehua\commands\opcommand\Clearup.java", "Java", 0, 63, 0, 0, 0, 9, 72
"d:\panling\yuehua-plugin\src\main\java\com\xiaoxiaoowo\yuehua\commands\opcommand\GI.java", "Java", 0, 963, 0, 0, 134, 95, 1192
"d:\panling\yuehua-plugin\src\main\java\com\xiaoxiaoowo\yuehua\commands\opcommand\MySave.java", "Java", 0, 22, 0, 0, 0, 4, 26
"d:\panling\yuehua-plugin\src\main\java\com\xiaoxiaoowo\yuehua\commands\opcommand\MyTp.java", "Java", 0, 98, 0, 0, 0, 6, 104
"d:\panling\yuehua-plugin\src\main\java\com\xiaoxiaoowo\yuehua\commands\opcommand\MyTpTab.java", "Java", 0, 26, 0, 0, 0, 6, 32
"d:\panling\yuehua-plugin\src\main\java\com\xiaoxiaoowo\yuehua\commands\opcommand\PerGet.java", "Java", 0, 55, 0, 0, 0, 13, 68
"d:\panling\yuehua-plugin\src\main\java\com\xiaoxiaoowo\yuehua\commands\opcommand\SetSign.java", "Java", 0, 45, 0, 0, 0, 14, 59
"d:\panling\yuehua-plugin\src\main\java\com\xiaoxiaoowo\yuehua\commands\opcommand\Summon.java", "Java", 0, 97, 0, 0, 0, 5, 102
"d:\panling\yuehua-plugin\src\main\java\com\xiaoxiaoowo\yuehua\commands\opcommand\data\DataCountGet.java", "Java", 0, 29, 0, 0, 0, 5, 34
"d:\panling\yuehua-plugin\src\main\java\com\xiaoxiaoowo\yuehua\commands\opcommand\data\DataGet.java", "Java", 0, 34, 0, 0, 0, 5, 39
"d:\panling\yuehua-plugin\src\main\java\com\xiaoxiaoowo\yuehua\commands\opcommand\data\DataSet.java", "Java", 0, 53, 0, 0, 0, 23, 76
"d:\panling\yuehua-plugin\src\main\java\com\xiaoxiaoowo\yuehua\commands\opcommand\data\ItemDataGet.java", "Java", 0, 43, 0, 0, 0, 7, 50
"d:\panling\yuehua-plugin\src\main\java\com\xiaoxiaoowo\yuehua\commands\playercommand\ArrowCMD.java", "Java", 0, 171, 0, 0, 0, 28, 199
"d:\panling\yuehua-plugin\src\main\java\com\xiaoxiaoowo\yuehua\commands\playercommand\Buy.java", "Java", 0, 82, 0, 0, 0, 16, 98
"d:\panling\yuehua-plugin\src\main\java\com\xiaoxiaoowo\yuehua\commands\playercommand\Kill.java", "Java", 0, 14, 0, 0, 0, 3, 17
"d:\panling\yuehua-plugin\src\main\java\com\xiaoxiaoowo\yuehua\commands\playercommand\MoneyCMD.java", "Java", 0, 416, 0, 0, 2, 62, 480
"d:\panling\yuehua-plugin\src\main\java\com\xiaoxiaoowo\yuehua\commands\playercommand\Sale.java", "Java", 0, 98, 0, 0, 0, 23, 121
"d:\panling\yuehua-plugin\src\main\java\com\xiaoxiaoowo\yuehua\commands\playercommand\Sell.java", "Java", 0, 150, 0, 0, 1, 31, 182
"d:\panling\yuehua-plugin\src\main\java\com\xiaoxiaoowo\yuehua\commands\playercommand\Yhteam.java", "Java", 0, 294, 0, 0, 0, 72, 366
"d:\panling\yuehua-plugin\src\main\java\com\xiaoxiaoowo\yuehua\commands\playercommand\YuanSuCMD.java", "Java", 0, 1027, 0, 0, 0, 26, 1053
"d:\panling\yuehua-plugin\src\main\java\com\xiaoxiaoowo\yuehua\commands\playercommand\completer\ArrowCom.java", "Java", 0, 27, 0, 0, 0, 7, 34
"d:\panling\yuehua-plugin\src\main\java\com\xiaoxiaoowo\yuehua\commands\playercommand\completer\BuyCom.java", "Java", 0, 18, 0, 0, 0, 4, 22
"d:\panling\yuehua-plugin\src\main\java\com\xiaoxiaoowo\yuehua\commands\playercommand\completer\MoneyCom.java", "Java", 0, 41, 0, 0, 0, 13, 54
"d:\panling\yuehua-plugin\src\main\java\com\xiaoxiaoowo\yuehua\commands\playercommand\completer\SaleCom.java", "Java", 0, 21, 0, 0, 0, 4, 25
"d:\panling\yuehua-plugin\src\main\java\com\xiaoxiaoowo\yuehua\commands\playercommand\completer\SellCom.java", "Java", 0, 21, 0, 0, 0, 4, 25
"d:\panling\yuehua-plugin\src\main\java\com\xiaoxiaoowo\yuehua\commands\playercommand\completer\Yhteam.java", "Java", 0, 33, 0, 0, 0, 9, 42
"d:\panling\yuehua-plugin\src\main\java\com\xiaoxiaoowo\yuehua\commands\playercommand\completer\YuanSuCom.java", "Java", 0, 35, 0, 0, 0, 8, 43
"d:\panling\yuehua-plugin\src\main\java\com\xiaoxiaoowo\yuehua\data\DanData.java", "Java", 0, 129, 0, 0, 1, 36, 166
"d:\panling\yuehua-plugin\src\main\java\com\xiaoxiaoowo\yuehua\data\Data.java", "Java", 0, 585, 0, 0, 8, 165, 758
"d:\panling\yuehua-plugin\src\main\java\com\xiaoxiaoowo\yuehua\data\GongData.java", "Java", 0, 79, 0, 0, 4, 30, 113
"d:\panling\yuehua-plugin\src\main\java\com\xiaoxiaoowo\yuehua\data\MonsterData.java", "Java", 0, 84, 0, 0, 0, 23, 107
"d:\panling\yuehua-plugin\src\main\java\com\xiaoxiaoowo\yuehua\data\PetData.java", "Java", 0, 42, 0, 0, 0, 14, 56
"d:\panling\yuehua-plugin\src\main\java\com\xiaoxiaoowo\yuehua\data\ZhanData.java", "Java", 0, 29, 0, 0, 1, 15, 45
"d:\panling\yuehua-plugin\src\main\java\com\xiaoxiaoowo\yuehua\data\slot\EnderChestSlot.java", "Java", 0, 12, 0, 0, 0, 4, 16
"d:\panling\yuehua-plugin\src\main\java\com\xiaoxiaoowo\yuehua\data\slot\Slot.java", "Java", 0, 12, 0, 0, 0, 9, 21
"d:\panling\yuehua-plugin\src\main\java\com\xiaoxiaoowo\yuehua\data\slot\SlotBuilder.java", "Java", 0, 102, 0, 0, 0, 29, 131
"d:\panling\yuehua-plugin\src\main\java\com\xiaoxiaoowo\yuehua\data\slot\SlotWithOneActiveSkill.java", "Java", 0, 14, 0, 0, 0, 8, 22
"d:\panling\yuehua-plugin\src\main\java\com\xiaoxiaoowo\yuehua\data\slot\SlotWithTwoActiveSkill.java", "Java", 0, 17, 0, 0, 0, 6, 23
"d:\panling\yuehua-plugin\src\main\java\com\xiaoxiaoowo\yuehua\display\test\TestDisplay.java", "Java", 0, 127, 0, 0, 3, 20, 150
"d:\panling\yuehua-plugin\src\main\java\com\xiaoxiaoowo\yuehua\display\test\TestRay.java", "Java", 0, 30, 0, 0, 5, 11, 46
"d:\panling\yuehua-plugin\src\main\java\com\xiaoxiaoowo\yuehua\display\utils\DisPlayUtils.java", "Java", 0, 229, 0, 0, 64, 67, 360
"d:\panling\yuehua-plugin\src\main\java\com\xiaoxiaoowo\yuehua\display\utils\ParticleUtils.java", "Java", 0, 348, 0, 0, 62, 105, 515
"d:\panling\yuehua-plugin\src\main\java\com\xiaoxiaoowo\yuehua\entity\monster\Renou.java", "Java", 0, 54, 0, 0, 17, 17, 88
"d:\panling\yuehua-plugin\src\main\java\com\xiaoxiaoowo\yuehua\entity\monster\Renou2.java", "Java", 0, 57, 0, 0, 17, 17, 91
"d:\panling\yuehua-plugin\src\main\java\com\xiaoxiaoowo\yuehua\entity\monster\east\normal\EastNormalZombie.java", "Java", 0, 50, 0, 0, 16, 16, 82
"d:\panling\yuehua-plugin\src\main\java\com\xiaoxiaoowo\yuehua\entity\npc\dz\ArmorChest.java", "Java", 0, 158, 0, 0, 4, 32, 194
"d:\panling\yuehua-plugin\src\main\java\com\xiaoxiaoowo\yuehua\entity\npc\dz\ArmorFeet.java", "Java", 0, 158, 0, 0, 4, 32, 194
"d:\panling\yuehua-plugin\src\main\java\com\xiaoxiaoowo\yuehua\entity\npc\dz\ArmorHead.java", "Java", 0, 159, 0, 0, 4, 32, 195
"d:\panling\yuehua-plugin\src\main\java\com\xiaoxiaoowo\yuehua\entity\npc\dz\ArmorLeg.java", "Java", 0, 158, 0, 0, 4, 32, 194
"d:\panling\yuehua-plugin\src\main\java\com\xiaoxiaoowo\yuehua\entity\npc\dz\BiWeapon.java", "Java", 0, 158, 0, 0, 4, 26, 188
"d:\panling\yuehua-plugin\src\main\java\com\xiaoxiaoowo\yuehua\entity\npc\dz\DUShipin.java", "Java", 0, 159, 0, 0, 4, 26, 189
"d:\panling\yuehua-plugin\src\main\java\com\xiaoxiaoowo\yuehua\entity\npc\dz\DanWeapon.java", "Java", 0, 86, 0, 0, 4, 21, 111
"d:\panling\yuehua-plugin\src\main\java\com\xiaoxiaoowo\yuehua\entity\npc\dz\Fabao1.java", "Java", 0, 119, 0, 0, 4, 24, 147
"d:\panling\yuehua-plugin\src\main\java\com\xiaoxiaoowo\yuehua\entity\npc\dz\Fabao2.java", "Java", 0, 119, 0, 0, 4, 24, 147
"d:\panling\yuehua-plugin\src\main\java\com\xiaoxiaoowo\yuehua\entity\npc\dz\Fabao3.java", "Java", 0, 119, 0, 0, 4, 24, 147
"d:\panling\yuehua-plugin\src\main\java\com\xiaoxiaoowo\yuehua\entity\npc\dz\GongWeapon.java", "Java", 0, 158, 0, 0, 4, 26, 188
"d:\panling\yuehua-plugin\src\main\java\com\xiaoxiaoowo\yuehua\entity\npc\dz\MIAOFAGE.java", "Java", 0, 40, 0, 0, 4, 11, 55
"d:\panling\yuehua-plugin\src\main\java\com\xiaoxiaoowo\yuehua\entity\npc\dz\MINGZHUTANG.java", "Java", 0, 40, 0, 0, 4, 11, 55
"d:\panling\yuehua-plugin\src\main\java\com\xiaoxiaoowo\yuehua\entity\npc\dz\TIEJIANGPU.java", "Java", 0, 40, 0, 0, 4, 11, 55
"d:\panling\yuehua-plugin\src\main\java\com\xiaoxiaoowo\yuehua\entity\npc\dz\XUESHIPIN.java", "Java", 0, 129, 0, 0, 4, 25, 158
"d:\panling\yuehua-plugin\src\main\java\com\xiaoxiaoowo\yuehua\entity\npc\dz\YIBAOLOU.java", "Java", 0, 40, 0, 0, 4, 11, 55
"d:\panling\yuehua-plugin\src\main\java\com\xiaoxiaoowo\yuehua\entity\npc\dz\Yiqi.java", "Java", 0, 158, 0, 0, 4, 26, 188
"d:\panling\yuehua-plugin\src\main\java\com\xiaoxiaoowo\yuehua\entity\npc\dz\Ys1.java", "Java", 0, 123, 0, 0, 4, 24, 151
"d:\panling\yuehua-plugin\src\main\java\com\xiaoxiaoowo\yuehua\entity\npc\dz\Ys2.java", "Java", 0, 121, 0, 0, 4, 24, 149
"d:\panling\yuehua-plugin\src\main\java\com\xiaoxiaoowo\yuehua\entity\npc\dz\Ys3.java", "Java", 0, 121, 0, 0, 4, 24, 149
"d:\panling\yuehua-plugin\src\main\java\com\xiaoxiaoowo\yuehua\entity\npc\dz\ZhanWeapon.java", "Java", 0, 158, 0, 0, 4, 26, 188
"d:\panling\yuehua-plugin\src\main\java\com\xiaoxiaoowo\yuehua\entity\npc\food\HAIXIANFAN.java", "Java", 0, 89, 0, 0, 4, 23, 116
"d:\panling\yuehua-plugin\src\main\java\com\xiaoxiaoowo\yuehua\entity\npc\food\HUNCAIFAN.java", "Java", 0, 89, 0, 0, 4, 23, 116
"d:\panling\yuehua-plugin\src\main\java\com\xiaoxiaoowo\yuehua\entity\npc\food\SHUIGUOFAN.java", "Java", 0, 116, 0, 0, 4, 25, 145
"d:\panling\yuehua-plugin\src\main\java\com\xiaoxiaoowo\yuehua\entity\npc\food\SUSHIFAN.java", "Java", 0, 89, 0, 0, 4, 23, 116
"d:\panling\yuehua-plugin\src\main\java\com\xiaoxiaoowo\yuehua\entity\npc\fulin\FuLingTaiYi.java", "Java", 0, 41, 0, 0, 4, 11, 56
"d:\panling\yuehua-plugin\src\main\java\com\xiaoxiaoowo\yuehua\entity\npc\fulin\KEHUASHI1.java", "Java", 0, 126, 0, 0, 4, 12, 142
"d:\panling\yuehua-plugin\src\main\java\com\xiaoxiaoowo\yuehua\entity\npc\fulin\KEHUASHI2.java", "Java", 0, 126, 0, 0, 4, 12, 142
"d:\panling\yuehua-plugin\src\main\java\com\xiaoxiaoowo\yuehua\entity\npc\fulin\KEHUASHI3.java", "Java", 0, 126, 0, 0, 4, 12, 142
"d:\panling\yuehua-plugin\src\main\java\com\xiaoxiaoowo\yuehua\entity\npc\middle\BUMINSHI.java", "Java", 0, 51, 0, 0, 4, 14, 69
"d:\panling\yuehua-plugin\src\main\java\com\xiaoxiaoowo\yuehua\entity\npc\middle\QianZhuang.java", "Java", 0, 86, 0, 0, 4, 17, 107
"d:\panling\yuehua-plugin\src\main\java\com\xiaoxiaoowo\yuehua\entity\npc\middle\ZAHUO.java", "Java", 0, 94, 0, 0, 4, 20, 118
"d:\panling\yuehua-plugin\src\main\java\com\xiaoxiaoowo\yuehua\entity\npc\middle\ZHINV.java", "Java", 0, 91, 0, 0, 4, 23, 118
"d:\panling\yuehua-plugin\src\main\java\com\xiaoxiaoowo\yuehua\entity\npc\yushi\Bingshuangshi.java", "Java", 0, 117, 0, 0, 4, 27, 148
"d:\panling\yuehua-plugin\src\main\java\com\xiaoxiaoowo\yuehua\entity\npc\yushi\Cuilvshi.java", "Java", 0, 116, 0, 0, 4, 27, 147
"d:\panling\yuehua-plugin\src\main\java\com\xiaoxiaoowo\yuehua\entity\npc\yushi\Dianlanshi.java", "Java", 0, 116, 0, 0, 4, 27, 147
"d:\panling\yuehua-plugin\src\main\java\com\xiaoxiaoowo\yuehua\entity\npc\yushi\Hongyueshi.java", "Java", 0, 116, 0, 0, 4, 27, 147
"d:\panling\yuehua-plugin\src\main\java\com\xiaoxiaoowo\yuehua\entity\npc\yushi\Houtushi.java", "Java", 0, 116, 0, 0, 4, 27, 147
"d:\panling\yuehua-plugin\src\main\java\com\xiaoxiaoowo\yuehua\entity\npc\yushi\Jinhuangshi.java", "Java", 0, 116, 0, 0, 4, 27, 147
"d:\panling\yuehua-plugin\src\main\java\com\xiaoxiaoowo\yuehua\entity\npc\yushi\Miyinshi.java", "Java", 0, 116, 0, 0, 4, 27, 147
"d:\panling\yuehua-plugin\src\main\java\com\xiaoxiaoowo\yuehua\entity\npc\yushi\Suiyanshi.java", "Java", 0, 116, 0, 0, 4, 27, 147
"d:\panling\yuehua-plugin\src\main\java\com\xiaoxiaoowo\yuehua\entity\npc\yushi\Tulushi.java", "Java", 0, 116, 0, 0, 4, 27, 147
"d:\panling\yuehua-plugin\src\main\java\com\xiaoxiaoowo\yuehua\entity\npc\yushi\Xueseshi.java", "Java", 0, 116, 0, 0, 4, 27, 147
"d:\panling\yuehua-plugin\src\main\java\com\xiaoxiaoowo\yuehua\entity\npc\yushi\Yanyangshi.java", "Java", 0, 116, 0, 0, 4, 27, 147
"d:\panling\yuehua-plugin\src\main\java\com\xiaoxiaoowo\yuehua\entity\npc\yushi\Yaochijinmu.java", "Java", 0, 41, 0, 0, 4, 19, 64
"d:\panling\yuehua-plugin\src\main\java\com\xiaoxiaoowo\yuehua\entity\npc\yushi\Yulushi.java", "Java", 0, 116, 0, 0, 4, 27, 147
"d:\panling\yuehua-plugin\src\main\java\com\xiaoxiaoowo\yuehua\entity\npc\yushi\Zijinshi.java", "Java", 0, 116, 0, 0, 4, 27, 147
"d:\panling\yuehua-plugin\src\main\java\com\xiaoxiaoowo\yuehua\entity\other\Pig.java", "Java", 0, 18, 0, 0, 5, 4, 27
"d:\panling\yuehua-plugin\src\main\java\com\xiaoxiaoowo\yuehua\event\Inventory\Click.java", "Java", 0, 3454, 0, 0, 39, 413, 3906
"d:\panling\yuehua-plugin\src\main\java\com\xiaoxiaoowo\yuehua\event\Inventory\Close.java", "Java", 0, 144, 0, 0, 0, 13, 157
"d:\panling\yuehua-plugin\src\main\java\com\xiaoxiaoowo\yuehua\event\Inventory\Open.java", "Java", 0, 18, 0, 0, 0, 4, 22
"d:\panling\yuehua-plugin\src\main\java\com\xiaoxiaoowo\yuehua\event\Projectile\Hit.java", "Java", 0, 45, 0, 0, 1, 8, 54
"d:\panling\yuehua-plugin\src\main\java\com\xiaoxiaoowo\yuehua\event\Projectile\Launch.java", "Java", 0, 25, 0, 0, 0, 6, 31
"d:\panling\yuehua-plugin\src\main\java\com\xiaoxiaoowo\yuehua\event\Spawner\Spawn.java", "Java", 0, 17, 0, 0, 3, 8, 28
"d:\panling\yuehua-plugin\src\main\java\com\xiaoxiaoowo\yuehua\event\entity\AddToWorld.java", "Java", 0, 25, 0, 0, 0, 7, 32
"d:\panling\yuehua-plugin\src\main\java\com\xiaoxiaoowo\yuehua\event\entity\Breed.java", "Java", 0, 10, 0, 0, 0, 4, 14
"d:\panling\yuehua-plugin\src\main\java\com\xiaoxiaoowo\yuehua\event\entity\Damage.java", "Java", 0, 74, 0, 0, 2, 25, 101
"d:\panling\yuehua-plugin\src\main\java\com\xiaoxiaoowo\yuehua\event\entity\DamageByEntity.java", "Java", 0, 663, 0, 0, 29, 191, 883
"d:\panling\yuehua-plugin\src\main\java\com\xiaoxiaoowo\yuehua\event\entity\Death.java", "Java", 0, 43, 0, 0, 2, 8, 53
"d:\panling\yuehua-plugin\src\main\java\com\xiaoxiaoowo\yuehua\event\entity\LoadCrossBow.java", "Java", 0, 35, 0, 0, 1, 7, 43
"d:\panling\yuehua-plugin\src\main\java\com\xiaoxiaoowo\yuehua\event\entity\PotionSpLash.java", "Java", 0, 31, 0, 0, 0, 5, 36
"d:\panling\yuehua-plugin\src\main\java\com\xiaoxiaoowo\yuehua\event\entity\RegainHealth.java", "Java", 0, 32, 0, 0, 0, 5, 37
"d:\panling\yuehua-plugin\src\main\java\com\xiaoxiaoowo\yuehua\event\entity\RemoveFromWorld.java", "Java", 0, 27, 0, 0, 0, 7, 34
"d:\panling\yuehua-plugin\src\main\java\com\xiaoxiaoowo\yuehua\event\entity\ShootBow.java", "Java", 0, 102, 0, 0, 3, 33, 138
"d:\panling\yuehua-plugin\src\main\java\com\xiaoxiaoowo\yuehua\event\entity\SlimeSpilt.java", "Java", 0, 10, 0, 0, 0, 3, 13
"d:\panling\yuehua-plugin\src\main\java\com\xiaoxiaoowo\yuehua\event\entity\Transform.java", "Java", 0, 10, 0, 0, 0, 4, 14
"d:\panling\yuehua-plugin\src\main\java\com\xiaoxiaoowo\yuehua\event\player\ConsumeItem.java", "Java", 0, 27, 0, 0, 4, 16, 47
"d:\panling\yuehua-plugin\src\main\java\com\xiaoxiaoowo\yuehua\event\player\Death.java", "Java", 0, 32, 0, 0, 69, 12, 113
"d:\panling\yuehua-plugin\src\main\java\com\xiaoxiaoowo\yuehua\event\player\DropItem.java", "Java", 0, 17, 0, 0, 0, 4, 21
"d:\panling\yuehua-plugin\src\main\java\com\xiaoxiaoowo\yuehua\event\player\FlowerPotManipulate.java", "Java", 0, 16, 0, 0, 0, 4, 20
"d:\panling\yuehua-plugin\src\main\java\com\xiaoxiaoowo\yuehua\event\player\Interact.java", "Java", 0, 654, 0, 0, 26, 145, 825
"d:\panling\yuehua-plugin\src\main\java\com\xiaoxiaoowo\yuehua\event\player\InventorySlotChange.java", "Java", 0, 684, 0, 0, 112, 53, 849
"d:\panling\yuehua-plugin\src\main\java\com\xiaoxiaoowo\yuehua\event\player\Join.java", "Java", 0, 267, 0, 0, 6, 50, 323
"d:\panling\yuehua-plugin\src\main\java\com\xiaoxiaoowo\yuehua\event\player\LevelChange.java", "Java", 0, 170, 0, 0, 5, 18, 193
"d:\panling\yuehua-plugin\src\main\java\com\xiaoxiaoowo\yuehua\event\player\Login.java", "Java", 0, 23, 0, 0, 0, 7, 30
"d:\panling\yuehua-plugin\src\main\java\com\xiaoxiaoowo\yuehua\event\player\Quit.java", "Java", 0, 107, 0, 0, 0, 11, 118
"d:\panling\yuehua-plugin\src\main\java\com\xiaoxiaoowo\yuehua\event\player\Swap.java", "Java", 0, 13, 0, 0, 0, 3, 16
"d:\panling\yuehua-plugin\src\main\java\com\xiaoxiaoowo\yuehua\event\player\Teleport.java", "Java", 0, 13, 0, 0, 0, 4, 17
"d:\panling\yuehua-plugin\src\main\java\com\xiaoxiaoowo\yuehua\guis\DuanZao.java", "Java", 0, 295, 0, 0, 0, 44, 339
"d:\panling\yuehua-plugin\src\main\java\com\xiaoxiaoowo\yuehua\guis\OpGui.java", "Java", 0, 16, 0, 0, 0, 7, 23
"d:\panling\yuehua-plugin\src\main\java\com\xiaoxiaoowo\yuehua\guis\Recipe.java", "Java", 0, 122, 0, 0, 0, 48, 170
"d:\panling\yuehua-plugin\src\main\java\com\xiaoxiaoowo\yuehua\guis\Yh.java", "Java", 0, 734, 0, 0, 0, 74, 808
"d:\panling\yuehua-plugin\src\main\java\com\xiaoxiaoowo\yuehua\itemstack\Book.java", "Java", 0, 318, 0, 0, 0, 41, 359
"d:\panling\yuehua-plugin\src\main\java\com\xiaoxiaoowo\yuehua\itemstack\dz\Core.java", "Java", 0, 3685, 0, 0, 61, 703, 4449
"d:\panling\yuehua-plugin\src\main\java\com\xiaoxiaoowo\yuehua\itemstack\dz\FuLing.java", "Java", 0, 862, 0, 0, 13, 89, 964
"d:\panling\yuehua-plugin\src\main\java\com\xiaoxiaoowo\yuehua\itemstack\dz\Ingredient.java", "Java", 0, 885, 0, 0, 29, 96, 1010
"d:\panling\yuehua-plugin\src\main\java\com\xiaoxiaoowo\yuehua\itemstack\dz\TehuaShui.java", "Java", 0, 316, 0, 0, 0, 82, 398
"d:\panling\yuehua-plugin\src\main\java\com\xiaoxiaoowo\yuehua\itemstack\dz\YuShi.java", "Java", 0, 1575, 0, 0, 13, 173, 1761
"d:\panling\yuehua-plugin\src\main\java\com\xiaoxiaoowo\yuehua\itemstack\dz\YuanSu.java", "Java", 0, 213, 0, 0, 4, 31, 248
"d:\panling\yuehua-plugin\src\main\java\com\xiaoxiaoowo\yuehua\itemstack\liandan\Dan.java", "Java", 0, 78, 0, 0, 1, 19, 98
"d:\panling\yuehua-plugin\src\main\java\com\xiaoxiaoowo\yuehua\itemstack\liandan\Herb.java", "Java", 0, 196, 0, 0, 4, 24, 224
"d:\panling\yuehua-plugin\src\main\java\com\xiaoxiaoowo\yuehua\itemstack\monsterzhuangbei\Boot.java", "Java", 0, 177, 0, 0, 0, 30, 207
"d:\panling\yuehua-plugin\src\main\java\com\xiaoxiaoowo\yuehua\itemstack\monsterzhuangbei\Bow.java", "Java", 0, 71, 0, 0, 0, 19, 90
"d:\panling\yuehua-plugin\src\main\java\com\xiaoxiaoowo\yuehua\itemstack\monsterzhuangbei\Chest.java", "Java", 0, 177, 0, 0, 0, 31, 208
"d:\panling\yuehua-plugin\src\main\java\com\xiaoxiaoowo\yuehua\itemstack\monsterzhuangbei\Helmet.java", "Java", 0, 109, 0, 0, 0, 27, 136
"d:\panling\yuehua-plugin\src\main\java\com\xiaoxiaoowo\yuehua\itemstack\monsterzhuangbei\Leg.java", "Java", 0, 93, 0, 0, 0, 29, 122
"d:\panling\yuehua-plugin\src\main\java\com\xiaoxiaoowo\yuehua\itemstack\monsterzhuangbei\Weapon.java", "Java", 0, 469, 0, 0, 23, 144, 636
"d:\panling\yuehua-plugin\src\main\java\com\xiaoxiaoowo\yuehua\itemstack\other\Collection.java", "Java", 0, 157, 0, 0, 0, 28, 185
"d:\panling\yuehua-plugin\src\main\java\com\xiaoxiaoowo\yuehua\itemstack\other\Feather.java", "Java", 0, 225, 0, 0, 0, 26, 251
"d:\panling\yuehua-plugin\src\main\java\com\xiaoxiaoowo\yuehua\itemstack\other\Food.java", "Java", 0, 642, 0, 0, 7, 63, 712
"d:\panling\yuehua-plugin\src\main\java\com\xiaoxiaoowo\yuehua\itemstack\other\FuBen.java", "Java", 0, 140, 0, 0, 2, 17, 159
"d:\panling\yuehua-plugin\src\main\java\com\xiaoxiaoowo\yuehua\itemstack\other\Money.java", "Java", 0, 94, 0, 0, 0, 22, 116
"d:\panling\yuehua-plugin\src\main\java\com\xiaoxiaoowo\yuehua\itemstack\other\MoneyLoot.java", "Java", 0, 202, 0, 0, 6, 55, 263
"d:\panling\yuehua-plugin\src\main\java\com\xiaoxiaoowo\yuehua\itemstack\other\Other.java", "Java", 0, 47, 0, 0, 0, 13, 60
"d:\panling\yuehua-plugin\src\main\java\com\xiaoxiaoowo\yuehua\itemstack\other\RaceProvince.java", "Java", 0, 86, 0, 0, 0, 25, 111
"d:\panling\yuehua-plugin\src\main\java\com\xiaoxiaoowo\yuehua\itemstack\other\XP.java", "Java", 0, 105, 0, 0, 1, 21, 127
"d:\panling\yuehua-plugin\src\main\java\com\xiaoxiaoowo\yuehua\itemstack\zhuangbei\ArmorChest.java", "Java", 0, 626, 0, 0, 4, 28, 658
"d:\panling\yuehua-plugin\src\main\java\com\xiaoxiaoowo\yuehua\itemstack\zhuangbei\ArmorFeet.java", "Java", 0, 617, 0, 0, 4, 28, 649
"d:\panling\yuehua-plugin\src\main\java\com\xiaoxiaoowo\yuehua\itemstack\zhuangbei\ArmorHead.java", "Java", 0, 626, 0, 0, 4, 57, 687
"d:\panling\yuehua-plugin\src\main\java\com\xiaoxiaoowo\yuehua\itemstack\zhuangbei\ArmorLeg.java", "Java", 0, 626, 0, 0, 4, 32, 662
"d:\panling\yuehua-plugin\src\main\java\com\xiaoxiaoowo\yuehua\itemstack\zhuangbei\BiWeapon.java", "Java", 0, 360, 0, 0, 3, 50, 413
"d:\panling\yuehua-plugin\src\main\java\com\xiaoxiaoowo\yuehua\itemstack\zhuangbei\Fabao.java", "Java", 0, 986, 0, 0, 12, 87, 1085
"d:\panling\yuehua-plugin\src\main\java\com\xiaoxiaoowo\yuehua\itemstack\zhuangbei\Shipin.java", "Java", 0, 1206, 0, 0, 0, 156, 1362
"d:\panling\yuehua-plugin\src\main\java\com\xiaoxiaoowo\yuehua\itemstack\zhuangbei\Weapon.java", "Java", 0, 743, 0, 0, 10, 65, 818
"d:\panling\yuehua-plugin\src\main\java\com\xiaoxiaoowo\yuehua\itemstack\zhuangbei\YiQi.java", "Java", 0, 360, 0, 0, 3, 49, 412
"d:\panling\yuehua-plugin\src\main\java\com\xiaoxiaoowo\yuehua\shilian\huancheng\HuanCheng.java", "Java", 0, 78, 0, 0, 1, 21, 100
"d:\panling\yuehua-plugin\src\main\java\com\xiaoxiaoowo\yuehua\system\Act.java", "Java", 0, 464, 0, 0, 1, 103, 568
"d:\panling\yuehua-plugin\src\main\java\com\xiaoxiaoowo\yuehua\system\BaoJi.java", "Java", 0, 26, 0, 0, 1, 4, 31
"d:\panling\yuehua-plugin\src\main\java\com\xiaoxiaoowo\yuehua\system\Cure.java", "Java", 0, 79, 0, 0, 4, 15, 98
"d:\panling\yuehua-plugin\src\main\java\com\xiaoxiaoowo\yuehua\system\Damage.java", "Java", 0, 176, 0, 0, 14, 66, 256
"d:\panling\yuehua-plugin\src\main\java\com\xiaoxiaoowo\yuehua\system\DataContainer.java", "Java", 0, 186, 0, 0, 18, 57, 261
"d:\panling\yuehua-plugin\src\main\java\com\xiaoxiaoowo\yuehua\system\DoJiNeng.java", "Java", 0, 143, 0, 0, 0, 53, 196
"d:\panling\yuehua-plugin\src\main\java\com\xiaoxiaoowo\yuehua\system\Team.java", "Java", 0, 43, 0, 0, 1, 9, 53
"d:\panling\yuehua-plugin\src\main\java\com\xiaoxiaoowo\yuehua\system\act\ActBiWeapon.java", "Java", 0, 3, 0, 0, 0, 2, 5
"d:\panling\yuehua-plugin\src\main\java\com\xiaoxiaoowo\yuehua\system\act\ActFabao.java", "Java", 0, 3, 0, 0, 0, 2, 5
"d:\panling\yuehua-plugin\src\main\java\com\xiaoxiaoowo\yuehua\system\act\ActFuling.java", "Java", 0, 838, 0, 0, 0, 106, 944
"d:\panling\yuehua-plugin\src\main\java\com\xiaoxiaoowo\yuehua\system\act\ActHujia.java", "Java", 0, 45, 0, 0, 0, 11, 56
"d:\panling\yuehua-plugin\src\main\java\com\xiaoxiaoowo\yuehua\system\act\ActShipin.java", "Java", 0, 3, 0, 0, 0, 2, 5
"d:\panling\yuehua-plugin\src\main\java\com\xiaoxiaoowo\yuehua\system\act\ActWeapon.java", "Java", 0, 3, 0, 0, 0, 2, 5
"d:\panling\yuehua-plugin\src\main\java\com\xiaoxiaoowo\yuehua\system\act\ActYiqi.java", "Java", 0, 3, 0, 0, 0, 2, 5
"d:\panling\yuehua-plugin\src\main\java\com\xiaoxiaoowo\yuehua\system\act\ActYuShi.java", "Java", 0, 1660, 0, 0, 0, 236, 1896
"d:\panling\yuehua-plugin\src\main\java\com\xiaoxiaoowo\yuehua\system\dz\Fabao.java", "Java", 0, 25, 0, 0, 3, 8, 36
"d:\panling\yuehua-plugin\src\main\java\com\xiaoxiaoowo\yuehua\system\dz\Help.java", "Java", 0, 39, 0, 0, 2, 8, 49
"d:\panling\yuehua-plugin\src\main\java\com\xiaoxiaoowo\yuehua\system\dz\LianDan.java", "Java", 0, 29, 0, 0, 6, 7, 42
"d:\panling\yuehua-plugin\src\main\java\com\xiaoxiaoowo\yuehua\system\dz\Shipin.java", "Java", 0, 17, 0, 0, 3, 4, 24
"d:\panling\yuehua-plugin\src\main\java\com\xiaoxiaoowo\yuehua\system\dz\TieJiangPu.java", "Java", 0, 44, 0, 0, 3, 20, 67
"d:\panling\yuehua-plugin\src\main\java\com\xiaoxiaoowo\yuehua\system\dz\Yiqi.java", "Java", 0, 26, 0, 0, 3, 7, 36
"d:\panling\yuehua-plugin\src\main\java\com\xiaoxiaoowo\yuehua\system\handleMonsters\DoMonsterAttack.java", "Java", 0, 25, 0, 0, 0, 5, 30
"d:\panling\yuehua-plugin\src\main\java\com\xiaoxiaoowo\yuehua\system\handleMonsters\DoMonsterAttacked.java", "Java", 0, 20, 0, 0, 0, 5, 25
"d:\panling\yuehua-plugin\src\main\java\com\xiaoxiaoowo\yuehua\system\handleMonsters\DoMonsterDeath.java", "Java", 0, 11, 0, 0, 0, 8, 19
"d:\panling\yuehua-plugin\src\main\java\com\xiaoxiaoowo\yuehua\system\handleMonsters\DoMonsterMoFaAttacked.java", "Java", 0, 20, 0, 0, 0, 4, 24
"d:\panling\yuehua-plugin\src\main\java\com\xiaoxiaoowo\yuehua\system\handleMonsters\DoMonsterShoot.java", "Java", 0, 9, 0, 0, 0, 4, 13
"d:\panling\yuehua-plugin\src\main\java\com\xiaoxiaoowo\yuehua\system\handleMonsters\DoMonsterWuLiAttacked.java", "Java", 0, 20, 0, 0, 0, 5, 25
"d:\panling\yuehua-plugin\src\main\java\com\xiaoxiaoowo\yuehua\system\handleObsevers\DoAttackObserver.java", "Java", 0, 12, 0, 0, 0, 3, 15
"d:\panling\yuehua-plugin\src\main\java\com\xiaoxiaoowo\yuehua\system\handleObsevers\DoAttackedObserver.java", "Java", 0, 47, 0, 0, 0, 7, 54
"d:\panling\yuehua-plugin\src\main\java\com\xiaoxiaoowo\yuehua\system\handleObsevers\DoBaojiObserver.java", "Java", 0, 12, 0, 0, 0, 4, 16
"d:\panling\yuehua-plugin\src\main\java\com\xiaoxiaoowo\yuehua\system\handleObsevers\DoCuredObserver.java", "Java", 0, 30, 0, 0, 0, 6, 36
"d:\panling\yuehua-plugin\src\main\java\com\xiaoxiaoowo\yuehua\system\handleObsevers\DoDeathObserver.java", "Java", 0, 10, 0, 0, 0, 4, 14
"d:\panling\yuehua-plugin\src\main\java\com\xiaoxiaoowo\yuehua\system\handleObsevers\DoHitObserver.java", "Java", 0, 12, 0, 0, 0, 4, 16
"d:\panling\yuehua-plugin\src\main\java\com\xiaoxiaoowo\yuehua\system\handleObsevers\DoHuDunObserver.java", "Java", 0, 11, 0, 0, 0, 3, 14
"d:\panling\yuehua-plugin\src\main\java\com\xiaoxiaoowo\yuehua\system\handleObsevers\DoJiNengObservers.java", "Java", 0, 11, 0, 0, 0, 3, 14
"d:\panling\yuehua-plugin\src\main\java\com\xiaoxiaoowo\yuehua\system\handleObsevers\DoPlayerProjectileObserver.java", "Java", 0, 14, 0, 0, 0, 5, 19
"d:\panling\yuehua-plugin\src\main\java\com\xiaoxiaoowo\yuehua\system\handleObsevers\DoZhenfaObserver.java", "Java", 0, 11, 0, 0, 0, 3, 14
"d:\panling\yuehua-plugin\src\main\java\com\xiaoxiaoowo\yuehua\system\handlePets\DoPetAttack.java", "Java", 0, 17, 0, 0, 0, 4, 21
"d:\panling\yuehua-plugin\src\main\java\com\xiaoxiaoowo\yuehua\system\handlePets\DoPetAttacked.java", "Java", 0, 12, 0, 0, 0, 4, 16
"d:\panling\yuehua-plugin\src\main\java\com\xiaoxiaoowo\yuehua\system\handlePets\DoPetDeath.java", "Java", 0, 10, 0, 0, 0, 7, 17
"d:\panling\yuehua-plugin\src\main\java\com\xiaoxiaoowo\yuehua\system\handlePets\DoPetShoot.java", "Java", 0, 9, 0, 0, 0, 5, 14
"d:\panling\yuehua-plugin\src\main\java\com\xiaoxiaoowo\yuehua\task\hujia\Xiong1.java", "Java", 0, 35, 0, 0, 0, 8, 43
"d:\panling\yuehua-plugin\src\main\java\com\xiaoxiaoowo\yuehua\task\other\SaleTask.java", "Java", 0, 106, 0, 0, 1, 16, 123
"d:\panling\yuehua-plugin\src\main\java\com\xiaoxiaoowo\yuehua\utils\Check.java", "Java", 0, 50, 0, 0, 0, 13, 63
"d:\panling\yuehua-plugin\src\main\java\com\xiaoxiaoowo\yuehua\utils\ComponentSet.java", "Java", 0, 37, 0, 0, 0, 14, 51
"d:\panling\yuehua-plugin\src\main\java\com\xiaoxiaoowo\yuehua\utils\GetEntity.java", "Java", 0, 1707, 0, 0, 165, 197, 2069
"d:\panling\yuehua-plugin\src\main\java\com\xiaoxiaoowo\yuehua\utils\LocationCheck.java", "Java", 0, 153, 0, 0, 0, 17, 170
"d:\panling\yuehua-plugin\src\main\java\com\xiaoxiaoowo\yuehua\utils\LocationSet.java", "Java", 0, 85, 0, 0, 1, 4, 90
"d:\panling\yuehua-plugin\src\main\java\com\xiaoxiaoowo\yuehua\utils\MoveEntity.java", "Java", 0, 32, 0, 0, 14, 22, 68
"d:\panling\yuehua-plugin\src\main\java\com\xiaoxiaoowo\yuehua\utils\MyLootTable.java", "Java", 0, 20, 0, 0, 0, 6, 26
"d:\panling\yuehua-plugin\src\main\java\com\xiaoxiaoowo\yuehua\utils\MySocket.java", "Java", 0, 169, 0, 0, 4, 35, 208
"d:\panling\yuehua-plugin\src\main\java\com\xiaoxiaoowo\yuehua\utils\PlaySound.java", "Java", 0, 92, 0, 0, 0, 34, 126
"d:\panling\yuehua-plugin\src\main\java\com\xiaoxiaoowo\yuehua\utils\SQL.java", "Java", 0, 2861, 0, 0, 53, 464, 3378
"d:\panling\yuehua-plugin\src\main\java\com\xiaoxiaoowo\yuehua\utils\Scheduler.java", "Java", 0, 40, 0, 0, 1, 14, 55
"d:\panling\yuehua-plugin\src\main\java\com\xiaoxiaoowo\yuehua\utils\SendInformation.java", "Java", 0, 71, 0, 0, 0, 24, 95
"d:\panling\yuehua-plugin\src\main\java\com\xiaoxiaoowo\yuehua\utils\Transfer.java", "Java", 0, 124, 0, 0, 0, 62, 186
"d:\panling\yuehua-plugin\src\main\java\com\xiaoxiaoowo\yuehua\utils\ZeroAttributeModifier.java", "Java", 0, 33, 0, 0, 0, 9, 42
"d:\panling\yuehua-plugin\src\main\resources\plugin.yml", "YAML", 84, 0, 0, 0, 0, 1, 85
"Total", "-", 84, 48930, 317, 1, 2039, 8307, 59678