"filename", "language", "Java", "YAML", "Markdown", "JSON", "comment", "blank", "total"
"d:\panling\yuehua-plugin\src\.VSCodeCounter\2024-10-18_14-33-33\details.md", "Markdown", 0, 0, 223, 0, 0, 6, 229
"d:\panling\yuehua-plugin\src\.VSCodeCounter\2024-10-18_14-33-33\diff-details.md", "Markdown", 0, 0, 9, 0, 0, 6, 15
"d:\panling\yuehua-plugin\src\.VSCodeCounter\2024-10-18_14-33-33\diff.md", "Markdown", 0, 0, 12, 0, 0, 7, 19
"d:\panling\yuehua-plugin\src\.VSCodeCounter\2024-10-18_14-33-33\results.json", "JSON", 0, 0, 0, 1, 0, 0, 1
"d:\panling\yuehua-plugin\src\.VSCodeCounter\2024-10-18_14-33-33\results.md", "Markdown", 0, 0, 73, 0, 0, 7, 80
"d:\panling\yuehua-plugin\src\main\java\com\xiaoxiaoowo\yuehua\Yuehua.java", "Java", 268, 0, 0, 0, 30, 52, 350
"d:\panling\yuehua-plugin\src\main\java\com\xiaoxiaoowo\yuehua\attribute\AttributeSet.java", "Java", 1895, 0, 0, 0, 0, 306, 2201
"d:\panling\yuehua-plugin\src\main\java\com\xiaoxiaoowo\yuehua\attribute\attributes\MyAttribute.java", "Java", 8, 0, 0, 0, 0, 6, 14
"d:\panling\yuehua-plugin\src\main\java\com\xiaoxiaoowo\yuehua\attribute\attributes\fangyu\Fakang.java", "Java", 34, 0, 0, 0, 0, 7, 41
"d:\panling\yuehua-plugin\src\main\java\com\xiaoxiaoowo\yuehua\attribute\attributes\fangyu\Gedang.java", "Java", 34, 0, 0, 0, 0, 7, 41
"d:\panling\yuehua-plugin\src\main\java\com\xiaoxiaoowo\yuehua\attribute\attributes\fangyu\Hujia.java", "Java", 34, 0, 0, 0, 0, 7, 41
"d:\panling\yuehua-plugin\src\main\java\com\xiaoxiaoowo\yuehua\attribute\attributes\fangyu\Renxing.java", "Java", 34, 0, 0, 0, 0, 7, 41
"d:\panling\yuehua-plugin\src\main\java\com\xiaoxiaoowo\yuehua\attribute\attributes\fangyu\Shengji.java", "Java", 34, 0, 0, 0, 0, 7, 41
"d:\panling\yuehua-plugin\src\main\java\com\xiaoxiaoowo\yuehua\attribute\attributes\fangyu\ShouHu.java", "Java", 34, 0, 0, 0, 0, 7, 41
"d:\panling\yuehua-plugin\src\main\java\com\xiaoxiaoowo\yuehua\attribute\attributes\jingong\ArrowAdd.java", "Java", 43, 0, 0, 0, 0, 14, 57
"d:\panling\yuehua-plugin\src\main\java\com\xiaoxiaoowo\yuehua\attribute\attributes\jingong\ArrowMul.java", "Java", 43, 0, 0, 0, 0, 14, 57
"d:\panling\yuehua-plugin\src\main\java\com\xiaoxiaoowo\yuehua\attribute\attributes\jingong\AttackAdd.java", "Java", 40, 0, 0, 0, 0, 14, 54
"d:\panling\yuehua-plugin\src\main\java\com\xiaoxiaoowo\yuehua\attribute\attributes\jingong\AttackMul.java", "Java", 40, 0, 0, 0, 0, 13, 53
"d:\panling\yuehua-plugin\src\main\java\com\xiaoxiaoowo\yuehua\attribute\attributes\jingong\BaoJi.java", "Java", 34, 0, 0, 0, 0, 7, 41
"d:\panling\yuehua-plugin\src\main\java\com\xiaoxiaoowo\yuehua\attribute\attributes\jingong\BaojiXiaoguo.java", "Java", 34, 0, 0, 0, 0, 7, 41
"d:\panling\yuehua-plugin\src\main\java\com\xiaoxiaoowo\yuehua\attribute\attributes\jingong\CoolReduce.java", "Java", 34, 0, 0, 0, 0, 7, 41
"d:\panling\yuehua-plugin\src\main\java\com\xiaoxiaoowo\yuehua\attribute\attributes\jingong\CoolReduceUnlimited.java", "Java", 30, 0, 0, 0, 0, 7, 37
"d:\panling\yuehua-plugin\src\main\java\com\xiaoxiaoowo\yuehua\attribute\attributes\jingong\JinGongMul.java", "Java", 87, 0, 0, 0, 0, 31, 118
"d:\panling\yuehua-plugin\src\main\java\com\xiaoxiaoowo\yuehua\attribute\attributes\jingong\JingongAdd.java", "Java", 90, 0, 0, 0, 0, 29, 119
"d:\panling\yuehua-plugin\src\main\java\com\xiaoxiaoowo\yuehua\attribute\attributes\jingong\Pofa.java", "Java", 34, 0, 0, 0, 0, 7, 41
"d:\panling\yuehua-plugin\src\main\java\com\xiaoxiaoowo\yuehua\attribute\attributes\jingong\Pojia.java", "Java", 34, 0, 0, 0, 0, 7, 41
"d:\panling\yuehua-plugin\src\main\java\com\xiaoxiaoowo\yuehua\attribute\attributes\jingong\ZhenfaAdd.java", "Java", 45, 0, 0, 0, 0, 14, 59
"d:\panling\yuehua-plugin\src\main\java\com\xiaoxiaoowo\yuehua\attribute\attributes\jingong\ZhenfaMul.java", "Java", 43, 0, 0, 0, 0, 16, 59
"d:\panling\yuehua-plugin\src\main\java\com\xiaoxiaoowo\yuehua\attribute\attributes\special\ArrowCountMax.java", "Java", 30, 0, 0, 0, 0, 7, 37
"d:\panling\yuehua-plugin\src\main\java\com\xiaoxiaoowo\yuehua\attribute\attributes\special\Danlu.java", "Java", 41, 0, 0, 0, 0, 9, 50
"d:\panling\yuehua-plugin\src\main\java\com\xiaoxiaoowo\yuehua\attribute\attributes\special\IsBow.java", "Java", 25, 0, 0, 0, 0, 5, 30
"d:\panling\yuehua-plugin\src\main\java\com\xiaoxiaoowo\yuehua\attribute\attributes\special\SlotWithId.java", "Java", 117, 0, 0, 0, 0, 8, 125
"d:\panling\yuehua-plugin\src\main\java\com\xiaoxiaoowo\yuehua\attribute\attributes\vanilla\AttackRange.java", "Java", 35, 0, 0, 0, 0, 8, 43
"d:\panling\yuehua-plugin\src\main\java\com\xiaoxiaoowo\yuehua\attribute\attributes\vanilla\AttackSpeed.java", "Java", 35, 0, 0, 0, 0, 7, 42
"d:\panling\yuehua-plugin\src\main\java\com\xiaoxiaoowo\yuehua\attribute\attributes\vanilla\DingLi.java", "Java", 36, 0, 0, 0, 0, 8, 44
"d:\panling\yuehua-plugin\src\main\java\com\xiaoxiaoowo\yuehua\attribute\attributes\vanilla\Hp.java", "Java", 35, 0, 0, 0, 0, 7, 42
"d:\panling\yuehua-plugin\src\main\java\com\xiaoxiaoowo\yuehua\attribute\attributes\vanilla\HpMul.java", "Java", 54, 0, 0, 0, 0, 11, 65
"d:\panling\yuehua-plugin\src\main\java\com\xiaoxiaoowo\yuehua\attribute\attributes\vanilla\Jump.java", "Java", 35, 0, 0, 0, 0, 8, 43
"d:\panling\yuehua-plugin\src\main\java\com\xiaoxiaoowo\yuehua\attribute\attributes\vanilla\Speed.java", "Java", 54, 0, 0, 0, 0, 10, 64
"d:\panling\yuehua-plugin\src\main\java\com\xiaoxiaoowo\yuehua\commands\Test.java", "Java", 996, 0, 0, 0, 659, 325, 1980
"d:\panling\yuehua-plugin\src\main\java\com\xiaoxiaoowo\yuehua\commands\blockcommand\BlockTp.java", "Java", 42, 0, 0, 0, 0, 6, 48
"d:\panling\yuehua-plugin\src\main\java\com\xiaoxiaoowo\yuehua\commands\blockcommand\IntoGame.java", "Java", 129, 0, 0, 0, 12, 23, 164
"d:\panling\yuehua-plugin\src\main\java\com\xiaoxiaoowo\yuehua\commands\blockcommand\MarkRelife.java", "Java", 64, 0, 0, 0, 0, 8, 72
"d:\panling\yuehua-plugin\src\main\java\com\xiaoxiaoowo\yuehua\commands\blockcommand\MyBossSpawn.java", "Java", 38, 0, 0, 0, 0, 9, 47
"d:\panling\yuehua-plugin\src\main\java\com\xiaoxiaoowo\yuehua\commands\blockcommand\MySpawn.java", "Java", 39, 0, 0, 0, 0, 11, 50
"d:\panling\yuehua-plugin\src\main\java\com\xiaoxiaoowo\yuehua\commands\blockcommand\Relife.java", "Java", 123, 0, 0, 0, 1, 19, 143
"d:\panling\yuehua-plugin\src\main\java\com\xiaoxiaoowo\yuehua\commands\blockcommand\RenOu.java", "Java", 64, 0, 0, 0, 0, 10, 74
"d:\panling\yuehua-plugin\src\main\java\com\xiaoxiaoowo\yuehua\commands\blockcommand\RenOu2.java", "Java", 65, 0, 0, 0, 0, 8, 73
"d:\panling\yuehua-plugin\src\main\java\com\xiaoxiaoowo\yuehua\commands\blockcommand\Select.java", "Java", 166, 0, 0, 0, 1, 19, 186
"d:\panling\yuehua-plugin\src\main\java\com\xiaoxiaoowo\yuehua\commands\blockcommand\StoreRelifeStone.java", "Java", 58, 0, 0, 0, 0, 14, 72
"d:\panling\yuehua-plugin\src\main\java\com\xiaoxiaoowo\yuehua\commands\opcommand\Clearup.java", "Java", 63, 0, 0, 0, 0, 9, 72
"d:\panling\yuehua-plugin\src\main\java\com\xiaoxiaoowo\yuehua\commands\opcommand\GI.java", "Java", 963, 0, 0, 0, 134, 95, 1192
"d:\panling\yuehua-plugin\src\main\java\com\xiaoxiaoowo\yuehua\commands\opcommand\MySave.java", "Java", 22, 0, 0, 0, 0, 4, 26
"d:\panling\yuehua-plugin\src\main\java\com\xiaoxiaoowo\yuehua\commands\opcommand\MyTp.java", "Java", 98, 0, 0, 0, 0, 6, 104
"d:\panling\yuehua-plugin\src\main\java\com\xiaoxiaoowo\yuehua\commands\opcommand\MyTpTab.java", "Java", 26, 0, 0, 0, 0, 6, 32
"d:\panling\yuehua-plugin\src\main\java\com\xiaoxiaoowo\yuehua\commands\opcommand\PerGet.java", "Java", 55, 0, 0, 0, 0, 13, 68
"d:\panling\yuehua-plugin\src\main\java\com\xiaoxiaoowo\yuehua\commands\opcommand\SetSign.java", "Java", 45, 0, 0, 0, 0, 14, 59
"d:\panling\yuehua-plugin\src\main\java\com\xiaoxiaoowo\yuehua\commands\opcommand\Summon.java", "Java", 97, 0, 0, 0, 0, 5, 102
"d:\panling\yuehua-plugin\src\main\java\com\xiaoxiaoowo\yuehua\commands\opcommand\data\DataCountGet.java", "Java", 29, 0, 0, 0, 0, 5, 34
"d:\panling\yuehua-plugin\src\main\java\com\xiaoxiaoowo\yuehua\commands\opcommand\data\DataGet.java", "Java", 34, 0, 0, 0, 0, 5, 39
"d:\panling\yuehua-plugin\src\main\java\com\xiaoxiaoowo\yuehua\commands\opcommand\data\DataSet.java", "Java", 53, 0, 0, 0, 0, 23, 76
"d:\panling\yuehua-plugin\src\main\java\com\xiaoxiaoowo\yuehua\commands\opcommand\data\ItemDataGet.java", "Java", 43, 0, 0, 0, 0, 7, 50
"d:\panling\yuehua-plugin\src\main\java\com\xiaoxiaoowo\yuehua\commands\playercommand\ArrowCMD.java", "Java", 171, 0, 0, 0, 0, 28, 199
"d:\panling\yuehua-plugin\src\main\java\com\xiaoxiaoowo\yuehua\commands\playercommand\Buy.java", "Java", 82, 0, 0, 0, 0, 16, 98
"d:\panling\yuehua-plugin\src\main\java\com\xiaoxiaoowo\yuehua\commands\playercommand\Kill.java", "Java", 14, 0, 0, 0, 0, 3, 17
"d:\panling\yuehua-plugin\src\main\java\com\xiaoxiaoowo\yuehua\commands\playercommand\MoneyCMD.java", "Java", 416, 0, 0, 0, 2, 62, 480
"d:\panling\yuehua-plugin\src\main\java\com\xiaoxiaoowo\yuehua\commands\playercommand\Sale.java", "Java", 98, 0, 0, 0, 0, 23, 121
"d:\panling\yuehua-plugin\src\main\java\com\xiaoxiaoowo\yuehua\commands\playercommand\Sell.java", "Java", 135, 0, 0, 0, 1, 27, 163
"d:\panling\yuehua-plugin\src\main\java\com\xiaoxiaoowo\yuehua\commands\playercommand\Yhteam.java", "Java", 294, 0, 0, 0, 0, 72, 366
"d:\panling\yuehua-plugin\src\main\java\com\xiaoxiaoowo\yuehua\commands\playercommand\YuanSuCMD.java", "Java", 1027, 0, 0, 0, 0, 26, 1053
"d:\panling\yuehua-plugin\src\main\java\com\xiaoxiaoowo\yuehua\commands\playercommand\completer\ArrowCom.java", "Java", 27, 0, 0, 0, 0, 7, 34
"d:\panling\yuehua-plugin\src\main\java\com\xiaoxiaoowo\yuehua\commands\playercommand\completer\BuyCom.java", "Java", 18, 0, 0, 0, 0, 4, 22
"d:\panling\yuehua-plugin\src\main\java\com\xiaoxiaoowo\yuehua\commands\playercommand\completer\MoneyCom.java", "Java", 41, 0, 0, 0, 0, 13, 54
"d:\panling\yuehua-plugin\src\main\java\com\xiaoxiaoowo\yuehua\commands\playercommand\completer\SaleCom.java", "Java", 21, 0, 0, 0, 0, 4, 25
"d:\panling\yuehua-plugin\src\main\java\com\xiaoxiaoowo\yuehua\commands\playercommand\completer\SellCom.java", "Java", 21, 0, 0, 0, 0, 4, 25
"d:\panling\yuehua-plugin\src\main\java\com\xiaoxiaoowo\yuehua\commands\playercommand\completer\Yhteam.java", "Java", 33, 0, 0, 0, 0, 9, 42
"d:\panling\yuehua-plugin\src\main\java\com\xiaoxiaoowo\yuehua\commands\playercommand\completer\YuanSuCom.java", "Java", 35, 0, 0, 0, 0, 8, 43
"d:\panling\yuehua-plugin\src\main\java\com\xiaoxiaoowo\yuehua\data\DanData.java", "Java", 135, 0, 0, 0, 1, 36, 172
"d:\panling\yuehua-plugin\src\main\java\com\xiaoxiaoowo\yuehua\data\Data.java", "Java", 592, 0, 0, 0, 8, 166, 766
"d:\panling\yuehua-plugin\src\main\java\com\xiaoxiaoowo\yuehua\data\GongData.java", "Java", 85, 0, 0, 0, 4, 33, 122
"d:\panling\yuehua-plugin\src\main\java\com\xiaoxiaoowo\yuehua\data\MonsterData.java", "Java", 84, 0, 0, 0, 0, 23, 107
"d:\panling\yuehua-plugin\src\main\java\com\xiaoxiaoowo\yuehua\data\PetData.java", "Java", 42, 0, 0, 0, 0, 14, 56
"d:\panling\yuehua-plugin\src\main\java\com\xiaoxiaoowo\yuehua\data\ZhanData.java", "Java", 30, 0, 0, 0, 1, 15, 46
"d:\panling\yuehua-plugin\src\main\java\com\xiaoxiaoowo\yuehua\data\slot\EnderChestSlot.java", "Java", 12, 0, 0, 0, 0, 4, 16
"d:\panling\yuehua-plugin\src\main\java\com\xiaoxiaoowo\yuehua\data\slot\Slot.java", "Java", 12, 0, 0, 0, 0, 9, 21
"d:\panling\yuehua-plugin\src\main\java\com\xiaoxiaoowo\yuehua\data\slot\SlotBuilder.java", "Java", 104, 0, 0, 0, 0, 30, 134
"d:\panling\yuehua-plugin\src\main\java\com\xiaoxiaoowo\yuehua\data\slot\SlotWithOneActiveSkill.java", "Java", 14, 0, 0, 0, 0, 8, 22
"d:\panling\yuehua-plugin\src\main\java\com\xiaoxiaoowo\yuehua\data\slot\SlotWithTwoActiveSkill.java", "Java", 17, 0, 0, 0, 0, 6, 23
"d:\panling\yuehua-plugin\src\main\java\com\xiaoxiaoowo\yuehua\display\test\TestDisplay.java", "Java", 127, 0, 0, 0, 3, 20, 150
"d:\panling\yuehua-plugin\src\main\java\com\xiaoxiaoowo\yuehua\display\test\TestRay.java", "Java", 30, 0, 0, 0, 5, 11, 46
"d:\panling\yuehua-plugin\src\main\java\com\xiaoxiaoowo\yuehua\display\utils\DisPlayUtils.java", "Java", 229, 0, 0, 0, 64, 67, 360
"d:\panling\yuehua-plugin\src\main\java\com\xiaoxiaoowo\yuehua\display\utils\ParticleUtils.java", "Java", 348, 0, 0, 0, 62, 105, 515
"d:\panling\yuehua-plugin\src\main\java\com\xiaoxiaoowo\yuehua\entity\monster\Renou.java", "Java", 54, 0, 0, 0, 17, 17, 88
"d:\panling\yuehua-plugin\src\main\java\com\xiaoxiaoowo\yuehua\entity\monster\Renou2.java", "Java", 57, 0, 0, 0, 17, 17, 91
"d:\panling\yuehua-plugin\src\main\java\com\xiaoxiaoowo\yuehua\entity\monster\east\normal\EastNormalZombie.java", "Java", 50, 0, 0, 0, 16, 16, 82
"d:\panling\yuehua-plugin\src\main\java\com\xiaoxiaoowo\yuehua\entity\npc\dz\ArmorChest.java", "Java", 158, 0, 0, 0, 4, 32, 194
"d:\panling\yuehua-plugin\src\main\java\com\xiaoxiaoowo\yuehua\entity\npc\dz\ArmorFeet.java", "Java", 158, 0, 0, 0, 4, 32, 194
"d:\panling\yuehua-plugin\src\main\java\com\xiaoxiaoowo\yuehua\entity\npc\dz\ArmorHead.java", "Java", 159, 0, 0, 0, 4, 32, 195
"d:\panling\yuehua-plugin\src\main\java\com\xiaoxiaoowo\yuehua\entity\npc\dz\ArmorLeg.java", "Java", 158, 0, 0, 0, 4, 32, 194
"d:\panling\yuehua-plugin\src\main\java\com\xiaoxiaoowo\yuehua\entity\npc\dz\BiWeapon.java", "Java", 158, 0, 0, 0, 4, 26, 188
"d:\panling\yuehua-plugin\src\main\java\com\xiaoxiaoowo\yuehua\entity\npc\dz\DUShipin.java", "Java", 159, 0, 0, 0, 4, 26, 189
"d:\panling\yuehua-plugin\src\main\java\com\xiaoxiaoowo\yuehua\entity\npc\dz\DanWeapon.java", "Java", 86, 0, 0, 0, 4, 21, 111
"d:\panling\yuehua-plugin\src\main\java\com\xiaoxiaoowo\yuehua\entity\npc\dz\Fabao1.java", "Java", 119, 0, 0, 0, 4, 24, 147
"d:\panling\yuehua-plugin\src\main\java\com\xiaoxiaoowo\yuehua\entity\npc\dz\Fabao2.java", "Java", 119, 0, 0, 0, 4, 24, 147
"d:\panling\yuehua-plugin\src\main\java\com\xiaoxiaoowo\yuehua\entity\npc\dz\Fabao3.java", "Java", 119, 0, 0, 0, 4, 24, 147
"d:\panling\yuehua-plugin\src\main\java\com\xiaoxiaoowo\yuehua\entity\npc\dz\GongWeapon.java", "Java", 158, 0, 0, 0, 4, 26, 188
"d:\panling\yuehua-plugin\src\main\java\com\xiaoxiaoowo\yuehua\entity\npc\dz\MIAOFAGE.java", "Java", 40, 0, 0, 0, 4, 11, 55
"d:\panling\yuehua-plugin\src\main\java\com\xiaoxiaoowo\yuehua\entity\npc\dz\MINGZHUTANG.java", "Java", 40, 0, 0, 0, 4, 11, 55
"d:\panling\yuehua-plugin\src\main\java\com\xiaoxiaoowo\yuehua\entity\npc\dz\TIEJIANGPU.java", "Java", 40, 0, 0, 0, 4, 11, 55
"d:\panling\yuehua-plugin\src\main\java\com\xiaoxiaoowo\yuehua\entity\npc\dz\XUESHIPIN.java", "Java", 129, 0, 0, 0, 4, 25, 158
"d:\panling\yuehua-plugin\src\main\java\com\xiaoxiaoowo\yuehua\entity\npc\dz\YIBAOLOU.java", "Java", 40, 0, 0, 0, 4, 11, 55
"d:\panling\yuehua-plugin\src\main\java\com\xiaoxiaoowo\yuehua\entity\npc\dz\Yiqi.java", "Java", 158, 0, 0, 0, 4, 26, 188
"d:\panling\yuehua-plugin\src\main\java\com\xiaoxiaoowo\yuehua\entity\npc\dz\Ys1.java", "Java", 123, 0, 0, 0, 4, 24, 151
"d:\panling\yuehua-plugin\src\main\java\com\xiaoxiaoowo\yuehua\entity\npc\dz\Ys2.java", "Java", 121, 0, 0, 0, 4, 24, 149
"d:\panling\yuehua-plugin\src\main\java\com\xiaoxiaoowo\yuehua\entity\npc\dz\Ys3.java", "Java", 121, 0, 0, 0, 4, 24, 149
"d:\panling\yuehua-plugin\src\main\java\com\xiaoxiaoowo\yuehua\entity\npc\dz\ZhanWeapon.java", "Java", 158, 0, 0, 0, 4, 26, 188
"d:\panling\yuehua-plugin\src\main\java\com\xiaoxiaoowo\yuehua\entity\npc\food\HAIXIANFAN.java", "Java", 89, 0, 0, 0, 4, 23, 116
"d:\panling\yuehua-plugin\src\main\java\com\xiaoxiaoowo\yuehua\entity\npc\food\HUNCAIFAN.java", "Java", 89, 0, 0, 0, 4, 23, 116
"d:\panling\yuehua-plugin\src\main\java\com\xiaoxiaoowo\yuehua\entity\npc\food\SHUIGUOFAN.java", "Java", 116, 0, 0, 0, 4, 25, 145
"d:\panling\yuehua-plugin\src\main\java\com\xiaoxiaoowo\yuehua\entity\npc\food\SUSHIFAN.java", "Java", 89, 0, 0, 0, 4, 23, 116
"d:\panling\yuehua-plugin\src\main\java\com\xiaoxiaoowo\yuehua\entity\npc\fulin\FuLingTaiYi.java", "Java", 41, 0, 0, 0, 4, 11, 56
"d:\panling\yuehua-plugin\src\main\java\com\xiaoxiaoowo\yuehua\entity\npc\fulin\KEHUASHI1.java", "Java", 126, 0, 0, 0, 4, 12, 142
"d:\panling\yuehua-plugin\src\main\java\com\xiaoxiaoowo\yuehua\entity\npc\fulin\KEHUASHI2.java", "Java", 126, 0, 0, 0, 4, 12, 142
"d:\panling\yuehua-plugin\src\main\java\com\xiaoxiaoowo\yuehua\entity\npc\fulin\KEHUASHI3.java", "Java", 126, 0, 0, 0, 4, 12, 142
"d:\panling\yuehua-plugin\src\main\java\com\xiaoxiaoowo\yuehua\entity\npc\middle\BUMINSHI.java", "Java", 51, 0, 0, 0, 4, 14, 69
"d:\panling\yuehua-plugin\src\main\java\com\xiaoxiaoowo\yuehua\entity\npc\middle\QianZhuang.java", "Java", 86, 0, 0, 0, 4, 17, 107
"d:\panling\yuehua-plugin\src\main\java\com\xiaoxiaoowo\yuehua\entity\npc\middle\ZAHUO.java", "Java", 94, 0, 0, 0, 4, 20, 118
"d:\panling\yuehua-plugin\src\main\java\com\xiaoxiaoowo\yuehua\entity\npc\middle\ZHINV.java", "Java", 91, 0, 0, 0, 4, 23, 118
"d:\panling\yuehua-plugin\src\main\java\com\xiaoxiaoowo\yuehua\entity\npc\yushi\Bingshuangshi.java", "Java", 117, 0, 0, 0, 4, 27, 148
"d:\panling\yuehua-plugin\src\main\java\com\xiaoxiaoowo\yuehua\entity\npc\yushi\Cuilvshi.java", "Java", 116, 0, 0, 0, 4, 27, 147
"d:\panling\yuehua-plugin\src\main\java\com\xiaoxiaoowo\yuehua\entity\npc\yushi\Dianlanshi.java", "Java", 116, 0, 0, 0, 4, 27, 147
"d:\panling\yuehua-plugin\src\main\java\com\xiaoxiaoowo\yuehua\entity\npc\yushi\Hongyueshi.java", "Java", 116, 0, 0, 0, 4, 27, 147
"d:\panling\yuehua-plugin\src\main\java\com\xiaoxiaoowo\yuehua\entity\npc\yushi\Houtushi.java", "Java", 116, 0, 0, 0, 4, 27, 147
"d:\panling\yuehua-plugin\src\main\java\com\xiaoxiaoowo\yuehua\entity\npc\yushi\Jinhuangshi.java", "Java", 116, 0, 0, 0, 4, 27, 147
"d:\panling\yuehua-plugin\src\main\java\com\xiaoxiaoowo\yuehua\entity\npc\yushi\Miyinshi.java", "Java", 116, 0, 0, 0, 4, 27, 147
"d:\panling\yuehua-plugin\src\main\java\com\xiaoxiaoowo\yuehua\entity\npc\yushi\Suiyanshi.java", "Java", 116, 0, 0, 0, 4, 27, 147
"d:\panling\yuehua-plugin\src\main\java\com\xiaoxiaoowo\yuehua\entity\npc\yushi\Tulushi.java", "Java", 116, 0, 0, 0, 4, 27, 147
"d:\panling\yuehua-plugin\src\main\java\com\xiaoxiaoowo\yuehua\entity\npc\yushi\Xueseshi.java", "Java", 116, 0, 0, 0, 4, 27, 147
"d:\panling\yuehua-plugin\src\main\java\com\xiaoxiaoowo\yuehua\entity\npc\yushi\Yanyangshi.java", "Java", 116, 0, 0, 0, 4, 27, 147
"d:\panling\yuehua-plugin\src\main\java\com\xiaoxiaoowo\yuehua\entity\npc\yushi\Yaochijinmu.java", "Java", 41, 0, 0, 0, 4, 19, 64
"d:\panling\yuehua-plugin\src\main\java\com\xiaoxiaoowo\yuehua\entity\npc\yushi\Yulushi.java", "Java", 116, 0, 0, 0, 4, 27, 147
"d:\panling\yuehua-plugin\src\main\java\com\xiaoxiaoowo\yuehua\entity\npc\yushi\Zijinshi.java", "Java", 116, 0, 0, 0, 4, 27, 147
"d:\panling\yuehua-plugin\src\main\java\com\xiaoxiaoowo\yuehua\entity\other\Pig.java", "Java", 18, 0, 0, 0, 5, 4, 27
"d:\panling\yuehua-plugin\src\main\java\com\xiaoxiaoowo\yuehua\event\Inventory\Click.java", "Java", 3455, 0, 0, 0, 39, 411, 3905
"d:\panling\yuehua-plugin\src\main\java\com\xiaoxiaoowo\yuehua\event\Inventory\Close.java", "Java", 160, 0, 0, 0, 0, 13, 173
"d:\panling\yuehua-plugin\src\main\java\com\xiaoxiaoowo\yuehua\event\Inventory\Open.java", "Java", 18, 0, 0, 0, 0, 4, 22
"d:\panling\yuehua-plugin\src\main\java\com\xiaoxiaoowo\yuehua\event\Projectile\Hit.java", "Java", 45, 0, 0, 0, 1, 8, 54
"d:\panling\yuehua-plugin\src\main\java\com\xiaoxiaoowo\yuehua\event\Projectile\Launch.java", "Java", 25, 0, 0, 0, 0, 6, 31
"d:\panling\yuehua-plugin\src\main\java\com\xiaoxiaoowo\yuehua\event\Spawner\Spawn.java", "Java", 17, 0, 0, 0, 3, 8, 28
"d:\panling\yuehua-plugin\src\main\java\com\xiaoxiaoowo\yuehua\event\entity\AddToWorld.java", "Java", 25, 0, 0, 0, 0, 7, 32
"d:\panling\yuehua-plugin\src\main\java\com\xiaoxiaoowo\yuehua\event\entity\Breed.java", "Java", 10, 0, 0, 0, 0, 4, 14
"d:\panling\yuehua-plugin\src\main\java\com\xiaoxiaoowo\yuehua\event\entity\Damage.java", "Java", 80, 0, 0, 0, 2, 29, 111
"d:\panling\yuehua-plugin\src\main\java\com\xiaoxiaoowo\yuehua\event\entity\DamageByEntity.java", "Java", 679, 0, 0, 0, 29, 196, 904
"d:\panling\yuehua-plugin\src\main\java\com\xiaoxiaoowo\yuehua\event\entity\Death.java", "Java", 43, 0, 0, 0, 2, 8, 53
"d:\panling\yuehua-plugin\src\main\java\com\xiaoxiaoowo\yuehua\event\entity\LoadCrossBow.java", "Java", 35, 0, 0, 0, 1, 7, 43
"d:\panling\yuehua-plugin\src\main\java\com\xiaoxiaoowo\yuehua\event\entity\PotionSpLash.java", "Java", 31, 0, 0, 0, 0, 5, 36
"d:\panling\yuehua-plugin\src\main\java\com\xiaoxiaoowo\yuehua\event\entity\RegainHealth.java", "Java", 35, 0, 0, 0, 0, 6, 41
"d:\panling\yuehua-plugin\src\main\java\com\xiaoxiaoowo\yuehua\event\entity\RemoveFromWorld.java", "Java", 27, 0, 0, 0, 0, 7, 34
"d:\panling\yuehua-plugin\src\main\java\com\xiaoxiaoowo\yuehua\event\entity\ShootBow.java", "Java", 102, 0, 0, 0, 3, 33, 138
"d:\panling\yuehua-plugin\src\main\java\com\xiaoxiaoowo\yuehua\event\entity\SlimeSpilt.java", "Java", 10, 0, 0, 0, 0, 3, 13
"d:\panling\yuehua-plugin\src\main\java\com\xiaoxiaoowo\yuehua\event\entity\Transform.java", "Java", 10, 0, 0, 0, 0, 4, 14
"d:\panling\yuehua-plugin\src\main\java\com\xiaoxiaoowo\yuehua\event\player\ConsumeItem.java", "Java", 34, 0, 0, 0, 4, 15, 53
"d:\panling\yuehua-plugin\src\main\java\com\xiaoxiaoowo\yuehua\event\player\Death.java", "Java", 32, 0, 0, 0, 69, 12, 113
"d:\panling\yuehua-plugin\src\main\java\com\xiaoxiaoowo\yuehua\event\player\DropItem.java", "Java", 17, 0, 0, 0, 0, 4, 21
"d:\panling\yuehua-plugin\src\main\java\com\xiaoxiaoowo\yuehua\event\player\FlowerPotManipulate.java", "Java", 16, 0, 0, 0, 0, 4, 20
"d:\panling\yuehua-plugin\src\main\java\com\xiaoxiaoowo\yuehua\event\player\Interact.java", "Java", 703, 0, 0, 0, 26, 147, 876
"d:\panling\yuehua-plugin\src\main\java\com\xiaoxiaoowo\yuehua\event\player\InventorySlotChange.java", "Java", 684, 0, 0, 0, 112, 53, 849
"d:\panling\yuehua-plugin\src\main\java\com\xiaoxiaoowo\yuehua\event\player\Join.java", "Java", 265, 0, 0, 0, 6, 49, 320
"d:\panling\yuehua-plugin\src\main\java\com\xiaoxiaoowo\yuehua\event\player\LevelChange.java", "Java", 172, 0, 0, 0, 5, 18, 195
"d:\panling\yuehua-plugin\src\main\java\com\xiaoxiaoowo\yuehua\event\player\Login.java", "Java", 23, 0, 0, 0, 0, 7, 30
"d:\panling\yuehua-plugin\src\main\java\com\xiaoxiaoowo\yuehua\event\player\Quit.java", "Java", 107, 0, 0, 0, 0, 11, 118
"d:\panling\yuehua-plugin\src\main\java\com\xiaoxiaoowo\yuehua\event\player\Swap.java", "Java", 13, 0, 0, 0, 0, 3, 16
"d:\panling\yuehua-plugin\src\main\java\com\xiaoxiaoowo\yuehua\event\player\Teleport.java", "Java", 13, 0, 0, 0, 0, 4, 17
"d:\panling\yuehua-plugin\src\main\java\com\xiaoxiaoowo\yuehua\guis\DuanZao.java", "Java", 318, 0, 0, 0, 0, 55, 373
"d:\panling\yuehua-plugin\src\main\java\com\xiaoxiaoowo\yuehua\guis\OpGui.java", "Java", 16, 0, 0, 0, 0, 7, 23
"d:\panling\yuehua-plugin\src\main\java\com\xiaoxiaoowo\yuehua\guis\Recipe.java", "Java", 122, 0, 0, 0, 0, 48, 170
"d:\panling\yuehua-plugin\src\main\java\com\xiaoxiaoowo\yuehua\guis\Yh.java", "Java", 737, 0, 0, 0, 0, 74, 811
"d:\panling\yuehua-plugin\src\main\java\com\xiaoxiaoowo\yuehua\itemstack\Book.java", "Java", 321, 0, 0, 0, 0, 41, 362
"d:\panling\yuehua-plugin\src\main\java\com\xiaoxiaoowo\yuehua\itemstack\dz\Core.java", "Java", 3685, 0, 0, 0, 61, 703, 4449
"d:\panling\yuehua-plugin\src\main\java\com\xiaoxiaoowo\yuehua\itemstack\dz\FuLing.java", "Java", 862, 0, 0, 0, 13, 89, 964
"d:\panling\yuehua-plugin\src\main\java\com\xiaoxiaoowo\yuehua\itemstack\dz\Ingredient.java", "Java", 885, 0, 0, 0, 29, 96, 1010
"d:\panling\yuehua-plugin\src\main\java\com\xiaoxiaoowo\yuehua\itemstack\dz\TehuaShui.java", "Java", 316, 0, 0, 0, 0, 82, 398
"d:\panling\yuehua-plugin\src\main\java\com\xiaoxiaoowo\yuehua\itemstack\dz\YuShi.java", "Java", 1575, 0, 0, 0, 13, 173, 1761
"d:\panling\yuehua-plugin\src\main\java\com\xiaoxiaoowo\yuehua\itemstack\dz\YuanSu.java", "Java", 213, 0, 0, 0, 4, 31, 248
"d:\panling\yuehua-plugin\src\main\java\com\xiaoxiaoowo\yuehua\itemstack\liandan\Dan.java", "Java", 78, 0, 0, 0, 1, 19, 98
"d:\panling\yuehua-plugin\src\main\java\com\xiaoxiaoowo\yuehua\itemstack\liandan\Herb.java", "Java", 196, 0, 0, 0, 4, 24, 224
"d:\panling\yuehua-plugin\src\main\java\com\xiaoxiaoowo\yuehua\itemstack\monsterzhuangbei\Boot.java", "Java", 177, 0, 0, 0, 0, 30, 207
"d:\panling\yuehua-plugin\src\main\java\com\xiaoxiaoowo\yuehua\itemstack\monsterzhuangbei\Bow.java", "Java", 71, 0, 0, 0, 0, 19, 90
"d:\panling\yuehua-plugin\src\main\java\com\xiaoxiaoowo\yuehua\itemstack\monsterzhuangbei\Chest.java", "Java", 177, 0, 0, 0, 0, 31, 208
"d:\panling\yuehua-plugin\src\main\java\com\xiaoxiaoowo\yuehua\itemstack\monsterzhuangbei\Helmet.java", "Java", 109, 0, 0, 0, 0, 27, 136
"d:\panling\yuehua-plugin\src\main\java\com\xiaoxiaoowo\yuehua\itemstack\monsterzhuangbei\Leg.java", "Java", 93, 0, 0, 0, 0, 29, 122
"d:\panling\yuehua-plugin\src\main\java\com\xiaoxiaoowo\yuehua\itemstack\monsterzhuangbei\Weapon.java", "Java", 469, 0, 0, 0, 23, 144, 636
"d:\panling\yuehua-plugin\src\main\java\com\xiaoxiaoowo\yuehua\itemstack\other\Collection.java", "Java", 157, 0, 0, 0, 0, 28, 185
"d:\panling\yuehua-plugin\src\main\java\com\xiaoxiaoowo\yuehua\itemstack\other\Feather.java", "Java", 225, 0, 0, 0, 0, 26, 251
"d:\panling\yuehua-plugin\src\main\java\com\xiaoxiaoowo\yuehua\itemstack\other\Food.java", "Java", 642, 0, 0, 0, 7, 63, 712
"d:\panling\yuehua-plugin\src\main\java\com\xiaoxiaoowo\yuehua\itemstack\other\FuBen.java", "Java", 140, 0, 0, 0, 2, 17, 159
"d:\panling\yuehua-plugin\src\main\java\com\xiaoxiaoowo\yuehua\itemstack\other\Money.java", "Java", 94, 0, 0, 0, 0, 22, 116
"d:\panling\yuehua-plugin\src\main\java\com\xiaoxiaoowo\yuehua\itemstack\other\MoneyLoot.java", "Java", 202, 0, 0, 0, 6, 55, 263
"d:\panling\yuehua-plugin\src\main\java\com\xiaoxiaoowo\yuehua\itemstack\other\Other.java", "Java", 47, 0, 0, 0, 0, 13, 60
"d:\panling\yuehua-plugin\src\main\java\com\xiaoxiaoowo\yuehua\itemstack\other\RaceProvince.java", "Java", 86, 0, 0, 0, 0, 25, 111
"d:\panling\yuehua-plugin\src\main\java\com\xiaoxiaoowo\yuehua\itemstack\other\XP.java", "Java", 105, 0, 0, 0, 1, 21, 127
"d:\panling\yuehua-plugin\src\main\java\com\xiaoxiaoowo\yuehua\itemstack\zhuangbei\ArmorChest.java", "Java", 979, 0, 0, 0, 4, 28, 1011
"d:\panling\yuehua-plugin\src\main\java\com\xiaoxiaoowo\yuehua\itemstack\zhuangbei\ArmorFeet.java", "Java", 958, 0, 0, 0, 4, 28, 990
"d:\panling\yuehua-plugin\src\main\java\com\xiaoxiaoowo\yuehua\itemstack\zhuangbei\ArmorHead.java", "Java", 967, 0, 0, 0, 4, 57, 1028
"d:\panling\yuehua-plugin\src\main\java\com\xiaoxiaoowo\yuehua\itemstack\zhuangbei\ArmorLeg.java", "Java", 970, 0, 0, 0, 4, 32, 1006
"d:\panling\yuehua-plugin\src\main\java\com\xiaoxiaoowo\yuehua\itemstack\zhuangbei\BiWeapon.java", "Java", 690, 0, 0, 0, 3, 56, 749
"d:\panling\yuehua-plugin\src\main\java\com\xiaoxiaoowo\yuehua\itemstack\zhuangbei\Fabao.java", "Java", 1304, 0, 0, 0, 12, 96, 1412
"d:\panling\yuehua-plugin\src\main\java\com\xiaoxiaoowo\yuehua\itemstack\zhuangbei\Shipin.java", "Java", 2133, 0, 0, 0, 0, 170, 2303
"d:\panling\yuehua-plugin\src\main\java\com\xiaoxiaoowo\yuehua\itemstack\zhuangbei\Weapon.java", "Java", 1363, 0, 0, 0, 10, 65, 1438
"d:\panling\yuehua-plugin\src\main\java\com\xiaoxiaoowo\yuehua\itemstack\zhuangbei\YiQi.java", "Java", 597, 0, 0, 0, 3, 49, 649
"d:\panling\yuehua-plugin\src\main\java\com\xiaoxiaoowo\yuehua\shilian\huancheng\HuanCheng.java", "Java", 86, 0, 0, 0, 1, 20, 107
"d:\panling\yuehua-plugin\src\main\java\com\xiaoxiaoowo\yuehua\system\Act.java", "Java", 427, 0, 0, 0, 1, 82, 510
"d:\panling\yuehua-plugin\src\main\java\com\xiaoxiaoowo\yuehua\system\Cure.java", "Java", 79, 0, 0, 0, 4, 15, 98
"d:\panling\yuehua-plugin\src\main\java\com\xiaoxiaoowo\yuehua\system\Damage.java", "Java", 236, 0, 0, 0, 18, 78, 332
"d:\panling\yuehua-plugin\src\main\java\com\xiaoxiaoowo\yuehua\system\DataContainer.java", "Java", 186, 0, 0, 0, 19, 58, 263
"d:\panling\yuehua-plugin\src\main\java\com\xiaoxiaoowo\yuehua\system\DoJiNeng.java", "Java", 143, 0, 0, 0, 0, 53, 196
"d:\panling\yuehua-plugin\src\main\java\com\xiaoxiaoowo\yuehua\system\Init.java", "Java", 137, 0, 0, 0, 0, 31, 168
"d:\panling\yuehua-plugin\src\main\java\com\xiaoxiaoowo\yuehua\system\Team.java", "Java", 43, 0, 0, 0, 1, 9, 53
"d:\panling\yuehua-plugin\src\main\java\com\xiaoxiaoowo\yuehua\system\act\ActFuling.java", "Java", 838, 0, 0, 0, 0, 106, 944
"d:\panling\yuehua-plugin\src\main\java\com\xiaoxiaoowo\yuehua\system\act\ActYuShi.java", "Java", 1660, 0, 0, 0, 0, 236, 1896
"d:\panling\yuehua-plugin\src\main\java\com\xiaoxiaoowo\yuehua\system\dz\Fabao.java", "Java", 27, 0, 0, 0, 3, 8, 38
"d:\panling\yuehua-plugin\src\main\java\com\xiaoxiaoowo\yuehua\system\dz\Help.java", "Java", 39, 0, 0, 0, 2, 8, 49
"d:\panling\yuehua-plugin\src\main\java\com\xiaoxiaoowo\yuehua\system\dz\LianDan.java", "Java", 29, 0, 0, 0, 6, 7, 42
"d:\panling\yuehua-plugin\src\main\java\com\xiaoxiaoowo\yuehua\system\dz\Shipin.java", "Java", 19, 0, 0, 0, 3, 4, 26
"d:\panling\yuehua-plugin\src\main\java\com\xiaoxiaoowo\yuehua\system\dz\TieJiangPu.java", "Java", 46, 0, 0, 0, 3, 20, 69
"d:\panling\yuehua-plugin\src\main\java\com\xiaoxiaoowo\yuehua\system\dz\Yiqi.java", "Java", 28, 0, 0, 0, 3, 7, 38
"d:\panling\yuehua-plugin\src\main\java\com\xiaoxiaoowo\yuehua\system\handleMonsters\DoMonsterAttack.java", "Java", 25, 0, 0, 0, 0, 5, 30
"d:\panling\yuehua-plugin\src\main\java\com\xiaoxiaoowo\yuehua\system\handleMonsters\DoMonsterAttacked.java", "Java", 20, 0, 0, 0, 0, 5, 25
"d:\panling\yuehua-plugin\src\main\java\com\xiaoxiaoowo\yuehua\system\handleMonsters\DoMonsterDeath.java", "Java", 11, 0, 0, 0, 0, 8, 19
"d:\panling\yuehua-plugin\src\main\java\com\xiaoxiaoowo\yuehua\system\handleMonsters\DoMonsterMoFaAttacked.java", "Java", 20, 0, 0, 0, 0, 4, 24
"d:\panling\yuehua-plugin\src\main\java\com\xiaoxiaoowo\yuehua\system\handleMonsters\DoMonsterShoot.java", "Java", 9, 0, 0, 0, 0, 4, 13
"d:\panling\yuehua-plugin\src\main\java\com\xiaoxiaoowo\yuehua\system\handleMonsters\DoMonsterWuLiAttacked.java", "Java", 20, 0, 0, 0, 0, 5, 25
"d:\panling\yuehua-plugin\src\main\java\com\xiaoxiaoowo\yuehua\system\handleObsevers\DoAttackObserver.java", "Java", 15, 0, 0, 0, 0, 4, 19
"d:\panling\yuehua-plugin\src\main\java\com\xiaoxiaoowo\yuehua\system\handleObsevers\DoAttackedObserver.java", "Java", 165, 0, 0, 0, 0, 36, 201
"d:\panling\yuehua-plugin\src\main\java\com\xiaoxiaoowo\yuehua\system\handleObsevers\DoBaojiObserver.java", "Java", 15, 0, 0, 0, 0, 5, 20
"d:\panling\yuehua-plugin\src\main\java\com\xiaoxiaoowo\yuehua\system\handleObsevers\DoCuredObserver.java", "Java", 14, 0, 0, 0, 0, 5, 19
"d:\panling\yuehua-plugin\src\main\java\com\xiaoxiaoowo\yuehua\system\handleObsevers\DoDeathObserver.java", "Java", 13, 0, 0, 0, 0, 5, 18
"d:\panling\yuehua-plugin\src\main\java\com\xiaoxiaoowo\yuehua\system\handleObsevers\DoHitObserver.java", "Java", 15, 0, 0, 0, 0, 4, 19
"d:\panling\yuehua-plugin\src\main\java\com\xiaoxiaoowo\yuehua\system\handleObsevers\DoHuDunObserver.java", "Java", 14, 0, 0, 0, 0, 4, 18
"d:\panling\yuehua-plugin\src\main\java\com\xiaoxiaoowo\yuehua\system\handleObsevers\DoJiNengObservers.java", "Java", 30, 0, 0, 0, 0, 8, 38
"d:\panling\yuehua-plugin\src\main\java\com\xiaoxiaoowo\yuehua\system\handleObsevers\DoPlayerProjectileObserver.java", "Java", 21, 0, 0, 0, 0, 8, 29
"d:\panling\yuehua-plugin\src\main\java\com\xiaoxiaoowo\yuehua\system\handleObsevers\DoZhenfaObserver.java", "Java", 31, 0, 0, 0, 0, 7, 38
"d:\panling\yuehua-plugin\src\main\java\com\xiaoxiaoowo\yuehua\system\handlePets\DoPetAttack.java", "Java", 17, 0, 0, 0, 0, 4, 21
"d:\panling\yuehua-plugin\src\main\java\com\xiaoxiaoowo\yuehua\system\handlePets\DoPetAttacked.java", "Java", 12, 0, 0, 0, 0, 4, 16
"d:\panling\yuehua-plugin\src\main\java\com\xiaoxiaoowo\yuehua\system\handlePets\DoPetDeath.java", "Java", 10, 0, 0, 0, 0, 7, 17
"d:\panling\yuehua-plugin\src\main\java\com\xiaoxiaoowo\yuehua\system\handlePets\DoPetShoot.java", "Java", 9, 0, 0, 0, 0, 5, 14
"d:\panling\yuehua-plugin\src\main\java\com\xiaoxiaoowo\yuehua\task\hujia\Xie1.java", "Java", 33, 0, 0, 0, 0, 9, 42
"d:\panling\yuehua-plugin\src\main\java\com\xiaoxiaoowo\yuehua\task\hujia\Xie2345.java", "Java", 39, 0, 0, 0, 1, 10, 50
"d:\panling\yuehua-plugin\src\main\java\com\xiaoxiaoowo\yuehua\task\hujia\Xiong1.java", "Java", 41, 0, 0, 0, 0, 10, 51
"d:\panling\yuehua-plugin\src\main\java\com\xiaoxiaoowo\yuehua\task\hujia\Xiong2345.java", "Java", 38, 0, 0, 0, 0, 9, 47
"d:\panling\yuehua-plugin\src\main\java\com\xiaoxiaoowo\yuehua\task\other\ReflectProjectile.java", "Java", 58, 0, 0, 0, 0, 17, 75
"d:\panling\yuehua-plugin\src\main\java\com\xiaoxiaoowo\yuehua\task\other\SaleTask.java", "Java", 112, 0, 0, 0, 1, 17, 130
"d:\panling\yuehua-plugin\src\main\java\com\xiaoxiaoowo\yuehua\utils\Check.java", "Java", 50, 0, 0, 0, 0, 13, 63
"d:\panling\yuehua-plugin\src\main\java\com\xiaoxiaoowo\yuehua\utils\ComponentSet.java", "Java", 50, 0, 0, 0, 0, 11, 61
"d:\panling\yuehua-plugin\src\main\java\com\xiaoxiaoowo\yuehua\utils\GetEntity.java", "Java", 1713, 0, 0, 0, 165, 198, 2076
"d:\panling\yuehua-plugin\src\main\java\com\xiaoxiaoowo\yuehua\utils\LocationCheck.java", "Java", 205, 0, 0, 0, 38, 43, 286
"d:\panling\yuehua-plugin\src\main\java\com\xiaoxiaoowo\yuehua\utils\LocationSet.java", "Java", 85, 0, 0, 0, 1, 4, 90
"d:\panling\yuehua-plugin\src\main\java\com\xiaoxiaoowo\yuehua\utils\MoveEntity.java", "Java", 39, 0, 0, 0, 14, 23, 76
"d:\panling\yuehua-plugin\src\main\java\com\xiaoxiaoowo\yuehua\utils\MyLootTable.java", "Java", 30, 0, 0, 0, 1, 7, 38
"d:\panling\yuehua-plugin\src\main\java\com\xiaoxiaoowo\yuehua\utils\MySocket.java", "Java", 207, 0, 0, 0, 4, 37, 248
"d:\panling\yuehua-plugin\src\main\java\com\xiaoxiaoowo\yuehua\utils\PlaySound.java", "Java", 161, 0, 0, 0, 0, 57, 218
"d:\panling\yuehua-plugin\src\main\java\com\xiaoxiaoowo\yuehua\utils\SQL.java", "Java", 2861, 0, 0, 0, 53, 464, 3378
"d:\panling\yuehua-plugin\src\main\java\com\xiaoxiaoowo\yuehua\utils\Scheduler.java", "Java", 40, 0, 0, 0, 1, 14, 55
"d:\panling\yuehua-plugin\src\main\java\com\xiaoxiaoowo\yuehua\utils\SendInformation.java", "Java", 75, 0, 0, 0, 0, 25, 100
"d:\panling\yuehua-plugin\src\main\java\com\xiaoxiaoowo\yuehua\utils\Transfer.java", "Java", 123, 0, 0, 0, 0, 64, 187
"d:\panling\yuehua-plugin\src\main\java\com\xiaoxiaoowo\yuehua\utils\ZeroAttributeModifier.java", "Java", 33, 0, 0, 0, 0, 9, 42
"d:\panling\yuehua-plugin\src\main\resources\plugin.yml", "YAML", 0, 84, 0, 0, 0, 1, 85
"Total", "-", 55950, 84, 317, 1, 2084, 8915, 67351